ಅಂಕದ ಪರದೆ ಏಳು	ಪ್ರಾರಂಭವಾಗು, ಆರಂಭವಾಗು
ಅಂಕಿತ ಹಾಕು	ಸಹಿ ಮಾಡು, ರುಜು ಮಾಡು
ಅಂಕದ ಪರದೆ ಬೀಳು	ಮುಗಿ ಕೊನೆಗೊಳ್ಳು
ಅಂಕುರಾರ್ಪಣ ಮಾಡು	ಪ್ರಾರಂಭಿಸು, ಮೊದಲು ಮಾಡು
ಅಂಕುಶ ಹಾಕು	ಅಡ್ಡಿ ಮಾಡು, ತಡೆಯೊಡ್ಡು
ಅಂಗಡಿ ಇಡು	ತೋರಿಸು, ಪ್ರದರ್ಶಿಸು
ಅಂಗೈ ನೆಲ್ಲಿ	ಕರತಲಾಮಲಕ, ಸ್ಪಷ್ಟ
ಅಂಗೈಯಲ್ಲಿ ಆಕಾಶ ತೋರಿಸು	ತೋರಿಕೆ ಮಾಡು, ಸುಳ್ಳು ಹೇಳು
ಅಂಗೈಯಲ್ಲಿ ಇಟ್ಟುಕೋ	ಜೋಪಾನವಾಗಿ ನೋಡಿಕೋ, ಕಾಪಾಡು
ಅಂಗೈಯಲ್ಲಿ ಜೀವ ಹಿಡಿದುಕೊಳ್ಳು	ಬಹಳ ಭಯದಿಂದಿರು, ಎಚ್ಚರದಿಂದಿರು
ಅಂಗೈ ಮುಂಗೈ ಮಾಡು	ವಂಚಿಸು, ಮೋಸ ಮಾಡು
ಅಂಡಿಗೆ ನೀರು ಬಿಡು	ಮಾಡಿದ ಉಪಕಾರವನ್ನು ಮರೆಯುವುದು
ಅಂತರಂಗವನ್ನು ಚುಚ್ಚು	ಮನಸ್ಸಿಗೆ ನೋವುಂಟು ಮಾಡು, ಬೇಸರಪಡಿಸು
ಅಂತರ ಪಿಶಾಚಿ	ನೆಲೆಯಿಲ್ಲದೆ ಅಲೆದಾಡು
ಅಂತರ್ಲಾಗ ಹಾಕು	ಬಹಳ ಪ್ರಯತ್ನಿಸು
ಅಕ್ಕಿಕಾಳಿಗೆ ಹೋಗು	ವಿವಾಹದ ಸಮಯಕ್ಕೆ ಮಾತ್ರ ಹೋಗುವುದು
ಅಕ್ಷತೆ ಕೊಟ್ಟು ಹೇಳು	ವಿಶೇಷ ರೀತಿಯಿಂದ ಕರೆಯುವುದು
ಅಕ್ಷತೆ ಬೀಳು	ವಿವಾಹವಾಗು, ಮದುವೆಯಾಗು
ಅಕ್ಷಯ ಪಾತ್ರೆ	ಸಮೃದ್ಧವಾಗುವುದು
ಅಗ್ನಿಪರೀಕ್ಷೆ	ಕಠಿಣವಾದ ಸಂದರ್ಭ
ಅಗ್ರತಾಂಬೂಲ	ವಿಶೇಷ ಗೌರವ, ವಿಶೇಷ ಮನ್ನಣೆ
ಅಗ್ರಪೀಠ	ಪ್ರಮುಖ ಸ್ಥಾನ, ಬಹಳ ಮರ್ಯಾದೆ
ಅಗ್ರವೀಳ್ಯ	ವಿಶೇಷ ಆಹ್ವಾನವನ್ನು ನೀಡು
ಅಜಗಜಾಂತರ	ಬಹಳ ವ್ಯತ್ಯಾಸ, ತುಂಬಾ ಅಂತರ
ಅಜ್ಜಮ್ಮನ ಕತೆ	ಕಟ್ಟುಕತೆ, ನಂಬಲಸಾಧ್ಯವಾದ ಸಂಗತಿ
ಅಜ್ಜಿಗೆ ಕೆಮ್ಮು ಕಲಿಸು	ಹಿರಿಯರಿಗೆ ಬುದ್ದಿ ಹೇಳು, ಅನುಭವಿಗೆ ವಿವರಿಸ
ಅಜ್ಜಿ ಪುರಾಣ	ಕಟ್ಟುಕಥೆ, ಪ್ರಸ್ತುತ ಸನ್ನಿವೇಶಕ್ಕೆ ಪೂರಕವಲ್ಲದ
ಅಟ್ಟಕ್ಕೇರಿಸು	ಬಹಳ ಹೊಗಳು, ಉಬ್ಬಿಸು
ಅಟ್ಟವನ್ನು ಬೆಟ್ಟ ಮಾಡು	ಉತ್ತೇಕ್ಷಿಸು, ಸಣ್ಣದನ್ನು ದೊಡ್ಡದನ್ನಾಗಿ ಮಾಡು
ಅಡವಿ ಪಾಲಾಗು	ಹಾಳಾಗು, ನಾಶವಾಗು
ಅಡಾವುಡಿ ಮನುಷ್ಯ	ಯಾವ ಕೆಲಸಕ್ಕೂ ಬಾರದವ
ಅಡಗೂಲಜ್ಜಿಯ ಕಥೆ	ಪ್ರಯೋಜನಕ್ಕೆ ಬಾರದ ವಿಷಯ
ಅಡುಗೆ ಮನೆಯ ಜಗಳ	ಸ್ತ್ರೀಯರ ಜಗಳ, ಅತೆತಿ ಸೊಸೆ ಗಲಾಟೆ
ಅಡ್ಡಕಸಬಿ	ಅನನುಭವಿ, ಕೆಲಸಕ್ಕೆ ಬಾರದವ
ಅಡ್ಡಗಾಲು ಹಾಕು	ತಡೆಯುಂಟುಮಾಡು, ಅಡ್ಡಿ ಮಾಡು
ಅಡ್ಡಗೋಡೆಯ ಮಾತು	ಸಂದಿಗ್ಧವಾದ ಹೇಳಿಕೆ, ಖಚಿತವಿಲ್ಲದ ನುಡಿ
ಅಡ್ಡಗೋಡೆಯ ಮೇಲಿನ ದೀಪ	ಖಚಿತವಲ್ಲದ, ನಿರ್ಧರಿತವಲ್ಲದ
ಅಡ್ಡದಾರಿ ಹಿಡಿ	ತಪ್ಪು ದಾರಿಯಲ್ಲಿ ನಡೆ, ಕೆಟ್ಟ ಮಾರ್ಗಕ್ಕೆ ಬೀಳು
ಅಡ್ಡಬಾಯಿ ಹಾಕು	ಮಾತಿನ ಮಧ್ಯೆ ಪ್ರವೇಶಿಸು
ಅತ್ತ ಕೆರೆ ಇತ್ತ ಬಾವಿ	ಇಕ್ಕಟ್ಟಿನ ಸ್ಥಿತಿ, ಕಷ್ಟಕರ ಸ್ಥಿತಿ
ಅನ್ನ ಕಿತ್ತುಕೊಳ್ಳು	ಜೀವನ ಮಾರ್ಗವನ್ನು ಹಾಳುಮಾಡು
ಅನ್ನಕ್ಕೆ ಕಲ್ಲು ಹಾಕು	ಜೀವನ ಮಾರ್ಗವನ್ನು ಕೆಡಿಸು
ಅನ್ನದ ಋಣ	ಆಯಸ್ಸು ಜೀವನ ಕಾಲ
ಅಪಾಯದ ಗಂಟೆ	ಅಪಾಯದ ಸೂಚನೆ
ಅಪ್ಪನೆಟ್ಟ ಆಲದ ಮರ	ಹಳೆಯ ಸಂಪ್ರದಾಯ
ಅಬ್ಬೇಪಾರಿ	ಜವಾಬ್ದಾರಿಯಿಲ್ಲದವನು
ಅಮ್ಮಾವ್ರ ಗಂಡ	ಹೆಂಡತಿ ಹೇಳಿದ ಹಾಗೆ ಕೇಳುವವನು
ಅರಣ್ಯರೋಧನ	ವ್ಯರ್ಥ ಆಲಾಪ
ಅರಿಷಿಣ ಕಾಮಾಲೆ	ಎಲ್ಲದರಲ್ಲೂ ಅಪನಂಬಿಕೆ
ಅರ್ಧ ಜೀವವಾಗು	ಜರ್ಝರಿತವಾಗು, ಬಹಳ ತೊಂದರೆಗೊಳಗಾಗು
ಅವತಾರ ಮುಗಿ	ಶಕ್ತಿ ಕುಗ್ಗಿಹೋಗುವುದು
ಅಳತೆ ಮಾಡು	ಪರೀಕ್ಷಿಸು, ವಿಚಾರಿಸು
ಅಳಲೆಕಾಯಿ ಪಂಡಿತ	ಹಳೆಯ ಕಾಲದ ವೈದ್ಯ, ನಾಟೀವೈದ್ಯ
ಅಳಿಲು ಸೇವೆ ಮಾಡು	ಅಲ್ಪಸೇವೆಯನ್ನು ಮಾಡು
ಆಕಾಶ ಕಳಚಿ ಬೀಳು	ದೊಡ್ಡ ಆಘಾತ ಉಂಟಾಗು
ಆಕಾಶಕ್ಕೆ ಏಣಿ ಹಾಕು	ಅಸಾಧ್ಯವಾದ ಕೆಲಸ ಮಾಡಲು ಯತ್ನಿಸು
ಆಕಾಶಕ್ಕೆ ಹಾರು	ಬಹಳ ಸಂತೋಷಗೊಳ್ಳು
ಆಕಾಶಕ್ಕೇರು	ಹೆಚ್ಚಾಗು, ಜಾಸ್ತಿಯಾಗು
ಆಕಾಶದಿಂದ ಧುಮುಕು	ಅತಿಶಯದಿಂದ ಕೂಡಿರು
ಆಕಾಶ ನೋಡು	ಏನೂ ತೋಚದಂತಾಗು, ಸುಮ್ಮನಿರು
ಆಕಾಶ ಭೂಮಿ ಒಂದು ಮಾಡು	ಬಹಳ ಗಲಾಟೆ ಮಾಡು
ಆಕಾಶ ಮುಟ್ಟು	ಬಹಳ ಎತ್ತರವಾಗು, ಉದ್ದವಾಗು
ಆಕಾಶವೇ ಹರಿದು ಬೀಳು	ಬೆಚ್ಚಿಬೀಳುವಂತೆ ಆಗು
ಆಡಿಕೊಳ್ಳು	ಅವಹೇಳನ ಮಾಡು, ಗೇಲಿ ಮಾಡು
ಆನೆ ಹೊಟ್ಟೆಯಲ್ಲಿ ಲದ್ದಿ	ಒಳ್ಳೆಯವರಿಗೆ ಕೆಟ್ಟಮಕ್ಕಳು ಹುಟ್ಟುವುದು
ಆರಕ್ಕೇರದೆ ಮೂರಕ್ಕಿಳಿಯದವನು	ಒಂದೇ ರೀತಿಯಲ್ಲಿ ವರ್ತಿಸುವನು
ಆಹಾರವಾಗು	ವಿಷಯವಾಗು
ಆಳವಾದ ಅನುಭವ	ಅತಿಶಯವಾದ ತಿಳಿವಳಿಕೆ
ಆಳಿನ ಮೇಲೆ ಬೀಳು	ಬಹಳ ಜನ ಸೇರಿ ಮಾಡುವ ಕೆಲಸ
ಇಂಗು ತಿಂದ ಮಂಗನಂತಾಗು	ಮೋಸ ಹೋಗು
ಇಂಗು ತಿನ್ನಿಸು	ಮೋಸ ಮಾಡು
ಇಂಬಳ ಹಿಡಿದ ಹಾಗೆ	ಪಟ್ಟು ಹಿಡಿದು ಮಾಡು
ಇಕ್ಕಳ ಹಾಕು	ಅಡ್ಡಿ ಮಾಡು
ಇದಿರು ಹಾಕಿಕೊಳ್ಳು	ವಿರೋಧ ಕಟ್ಟಿಕೊಳ್ಳು
ಇಬ್ಬಂದಿ ಮನುಷ್ಯ	ಒಂದನ್ನು ಎರಡು ಮಾಡುವವ
ಇರುವೆ ಬಿಟ್ಟುಕೊಳ್ಳು	ತಾನಾಗಿಯೇ ಕಷ್ಟಕ್ಕೆ ಸಿಕ್ಕಿಹಾಕಿಕೊಳ್ಳು
ಇಳಿದು ಹೋಗು	ಬಡವಾಗು, ಕೃಶವಾಗು
ಉಂಡ ಮನೆಗೆ ಎರಡು ಬಗೆ	ಉಪಕಾರ ಮಾಡಿದವನಿಗೆ ಕೇಡು ಬಗ
ಉಂಡಾಡಿ ಗುಂಡ	ತಿಂದು ತಿರುಗುವವನು, ಉಡಾಳ
ಉಕ್ಕಿನ ಕಡಲೆ	ಕಠಿಣವಾದ ಸಂಗತಿ
ಉಗುರು ಕಡಿ	ಚಿಂತಾಕ್ರಾಂತನಾಗು
ಉಗುಳು ದಾಟು	ಮಾತನ್ನು ಮೀರು, ಅತಿಕ್ರಮಿಸು
ಉಗುಳು ನುಂಗು	ಅನುಮಾನಿಸು, ಅಧೈರ್ಯ ಪಡು
ಉಚ್ಚೇಲಿ ಮೀನು ಹಿಡಿ	ಸಣ್ಣತನ ಮಾಡು, ಜಿಪುಣತನ
ಉಡದ ಹಿಡಿತ	ಭದ್ರವಾದ ಹಿಡಿತ
ಉಡಿಯೊಳಗೆ ಹಾಕು	ರಕ್ಷಣೆಗೆ ಒಪ್ಪಿಸು
ಉತ್ತರ ಕುಮಾರ	ಹೇಡಿ, ಕೈಲಾಗದವನ
ಉತ್ತರನ ಪೌರುಷ	ಹೆಂಗಸರ ಮುಂದೆ ವೀರ - ಧೀರ ಎಂದು ಹೇಳಿಕೊಳ್ಳುವುದು
ಉತ್ಸವ ಮೂರ್ತಿ	ಅಲಂಕಾರಕ್ಕೆ ಮಾತ್ರ ಇರುವವನು
ಉಪ್ಪಿನ ಋಣ	ಕೃತಜ್ಞತೆ, ಉಪಕಾರ ಸ್ಮರಣೆ
ಉಪ್ಪಿಲ್ಲ ಹುಳಿಯಿಲ್ಲ	ನೀರಸ, ಸ್ವಾರಸ್ಯವಿಲ್ಲದ
ಉಪ್ಪು ಬರುವ ಹೊತುತಿ	ಒಳ್ಳೆಯ ಸಮಯ ಬರುವ ಹೊತ್ತು
ಉಪ್ಪುಹಾಕು	ಪ್ರಚೋದಿಸು, ಉತ್ತೇಜಿಸು
ಉರಿ ಇಡು	ಜಗಳ ಹುಟ್ಟಿಸು, ದ್ವೇಷ ಬೆಳೆಸು
ಉರಿದು ಉಪ್ಪಾಕು	ಗೋಳು ಹೊಯ್ದುಕೊಳ್ಳು
ಉರಿದು ಹೋಗು	ಕರುಬು, ಕೋಪಗೊಳ್ಳು
ಉರುಳು ಹಾಕಿಕೊಳ್ಳು	ತೊಂದರೆ ತಂದುಕೊಳ್ಳು
ಉಸಿರು ಅಡಗಿಸು	ಸಾಯಿಸು, ನಾಶಪಡಿಸು
ಉಸಿರು ಉಡುಗು	ನಾಶವಾಗು, ಮಾತುನಿಲ್ಲು
ಉಸಿರು ಎತ್ತದಂತೆ ಮಾಡು	ಉತ್ತರವಿಲ್ಲದಂತೆ ಮಾಡು, ಮೂಕನನ್ನಾಗಿಸು
ಉಸಿರು ಕಟ್ಟಿಸು	ಸ್ತಂಭೀಭೂತನನ್ನಾಗಿ ಮಾಡು, ಸುಮ್ಮನಿರಿಸು
ಉಸಿರು ಕೊಡು	ಉತ್ಸಾಹಿಸು, ಉತ್ತೇಜನ ನೀಡು
ಉಸಿರು ತಟ್ಟು	ಶಾಪ ತಟ್ಟು
ಉಸಿರು ಬಿಗಿ ಹಿಡಿ	ತೆಪ್ಪಗಿರು, ಮಾತನಾಡದಂತೆ ಇರು
ಊಟಕ್ಕಿಲ್ಲದ ಉಪ್ಪಿನಕಾಯಿ	ಸಮಯಕ್ಕೆ ಒದಗದ ವಸ್ತು
ಊರ ದನಕಾಯಿ	ಬೇರೆಯವರ ಕೆಲಸ ಮಾಡು, ಪರೋಪಕಾರಿ
ಊರು ಕೇರಿ ಒಂದು ಮಾಡು	ಕಿತ್ತಾಡು, ಜೋರಾಗಿ ಜಗಳವಾಡು
ಊರು ಬಸವಿ	ಜಗಳಗಂಟಿ, ಗಯ್ಯಾಳಿ
ಎಂಜಲಿಗೆ ಕೈಯೊಡ್ಡು	ಹಂಗಿಗೊಳಗಾಗು
ಎಂಜಲು ಕೈಯ್ಯಲ್ಲಿ ಕಾಗೆ ಓಡಿಸದಿರು	ತುಂಬಾ ಜಿಪುಣತನ ತೋರಿಸು
ಎಂಟೆದೆ	ಬಹಳ ಧೈರ್ಯ, ಎದೆಗಾರಿಕೆ
ಬಹಳ ಧೈರ್ಯ, ಎದೆಗಾರಿಕೆ	ಹಾಳಾಗು
ಎಡಗೈಲಿ ಜೀವ ಹಿಡಿದುಕೊಳ್ಳು	ಬಹಳ ಭಯಪಡು
ಎಣ್ಣೆ ಬಂದಾಗ ಕಣ್ಣು ಮುಚ್ಚಳ್ಳುವುದು	ಫಲ ಬರುವ ಸಮಯಕ್ಕೆ ಸುಮ್ಮನಿರುವುದು
ಎಣ್ಣೆ ಸೀಗೆಕಾಯಿ	ಬಹಳ ದ್ವೇಷ, ಬದ್ಧ ವೈರತ್ವ
ಎತ್ತಂಗಡಿ ಮಾಡಿಸು	ವರ್ಗಾವಣೆ ಮಾಡು, ಸ್ಥಳಾಂತರಗೊಳಿಸು
ಎತ್ತಿ ಆಡು	ಮುಖ್ಯವಾಗಿ ಗಮನಿಸು, ದೋಷ ಗುರುತಿಸು
ಎತ್ತಿಕಟ್ಟು	ಚಾಡಿ ಹೇಳು, ಪ್ರಚೋದಿಸು
ಎತ್ತಿ ತೋರಿಸು	ಎದ್ದು ಕಾಣುವಂತೆ ಮಾಡು, ಸ್ಪಷ್ಟ ಪಡಿಸು
ಎತ್ತಿಹಾಕು	ಅಪಹರಿಸು, ಮೀರು
ಎದುರು ನೋಡು	ನಿರೀಕ್ಷಿಸು, ಕಾಯು
ಎದುರು ಬೀಳು	ಪ್ರತಿಭಟಿಸು, ವಿರೋಧಿಸು
ಎದುರು ಹಾಕಿಕೊಳ್ಳು	ವಿರೋಧ ಕಟ್ಟಿಕೊಳ್ಳು
ಎದೆ ಉಬ್ಬಿನಿಲ್ಲು	ತುಂಬ ಸಂತೋಷವಾಗು
ಎದೆ ಒಡೆ	ಧೈರ್ಯಗುಂದು
ಎದೆ ಕರಗು	ಮರುಕ ಹುಟ್ಟು ಅನುಕಂಪಗೊಳ್ಳು
ಎದೆ ಗಟ್ಟಿ ಮಾಡಿಕೊಳ್ಳು	ಧೈರ್ಯ ತಂದುಕೊಳ್ಳು
ಎದೆಗಾರ	ಧೀರ, ಧೈರ್ಯಶಾಲಿ
ಎದೆಗೆಡು	ಧೈರ್ಯ ಗುಂದು
ಎದೆ ತಟ್ಟಿ ಹೇಳು	ಖಚಿತವಾಗಿ ಹೇಳು, ಧೈರ್ಯದಿಂದ ಹೇಳು
ಎದೆತುಂಬಿ ಬರು	ಬಹಳವಾಗಿ ಸಂತೋಷಪಡು, ಹರ್ಷಿಸು
ಎದೆ ತುಂಬಿ ಹಾಡು	ಹೃದಯಪೂರ್ವಕವಾಗಿ ಹಾಡು, ತನ್ಮಯತೆಯಿಂದ ಹಾಡು
ಎದೆ ಬಿರಿದು ಹೋಗು	ತುಂಬಾ ಸಂಕಟವಾಗು, ನೋವು ಅನುಭವಿಸು
ಎದೆ ಭಾರವಾಗು	ದುಃಖವಾಗು
ಎದೆ ಮುಟ್ಟಿಕೊಂಡು ಹೇಳು	ಆತ್ಮಸಾಕ್ಷಿಯಿಂದ ಹೇಳು
ಎದೆಯನ್ನು ಕಲ್ಲು ಮಾಡಿಕೊಳ್ಳು	ನೋವನ್ನು ಸಹಿಸಿಕೊಳ್ಳು
ಎದ್ದು ಕಾಣು	ಸ್ಪಷ್ಟವಾಗಿ ತೋರು
ಎಮ್ಮೆ ತಮ್ಮಣ್ಣ	ಮೂರ್ಖ, ಹೆಡ್ಡ
ಎಮ್ಮೆ ಮೇಲೆ ಮಳೆ ಹೊಯ್ಯು	ಪರಿಣಾಮವಿಲ್ಲದಿರುವುದು, ವ್ಯರ್ಥ
ಎರಡು ಜೀವದವಳು	ಬಸುರಿ, ಗರ್ಭಿಣಿ
ಎರಡು ತಲೆ ಹಾವು	ಇಬ್ಬರಿಗೂ ಮೋಸ ಮಾಡುವವನು, ನಂಬಿಕೆಗೆ ಅರ್ಹನಲ್ಲದವನು
ಎರಡು ನಾಲಿಗೆಯವನು	ಸುಳ್ಳು ಹೇಳುವವನು
ಎರಡು ಬಗೆ	ಮೋಸಮಾಡು, ಕೆಟ್ಟದ್ದನ್ನು ಮಾಡು
ಎಲೆಮರೆಯ ಕಾಯಿ	ಯಾವುದೇ ಪ್ರತಿಫಲ ಬಯಸದೇ ಕೆಲಸ ಮಾಡುವವ
ಎಲ್ಲರ ಬಾಯಲ್ಲೂ ಇರು	ಪ್ರಸಿದ್ಧನಾಗು, ಪ್ರಚಾರ ಹೊಂದು
ಎಳೆ ನಿಂಬೆಕಾಯಿ	ಅನನುಭವಿ, ನಿರನುಭವಿ
ಎಳ್ಳು ನೀರು ಬಿಡು	ತ್ಯಾಗ ಮಾಡು, ಆಸೆ ಬಿಡು
ಏಕಕಂಠ	ಒಮ್ಮತ, ಒಟ್ಟಿಗೆ ಹೇಳುವುದು
ಏಟು ತಿನ್ನು	ಸೋಲು, ಅಪಜಯ
ಏತಿ ಅಂದ್ರೆ ಪ್ರೇತಿ ಅನ್ನು	ಎಲ್ಲದಕ್ಕೂ ವಿರೋಧ ವ್ಯಕ್ತಪಡಿಸುವವ
ಏಳನೆಯ ತಿಂಗಳಲ್ಲಿ ಹುಟ್ಟಿದವನು	ಎಲ್ಲ ಕಾರ್ಯಗಳಲ್ಲಿ ಅವಸರಿಸುವವ
ಏಳು ಕೆರೆಯ ನೀರು ಕುಡಿದವ	ಬಹಳ ಅನುಭವಶಾಲಿ
ಏಳು ಹನ್ನೊಂದಾಗು	ಹಾಳಾಗು, ನಾಶವಾಗು
ಒಂಟಿಗಾಲ ಮೇಲೆ ನಿಲ್ಲು	ಆತುರವಾಗು
ಒಂದು ಕಣ್ಣಿಗೆ ಬೆಣ್ಣೆ ಒಂದು ಕಣ್ಣಿಗೆ ಸುಣ್ಣ	ಭೇದಭಾವ, ಪಕ್ಷಪಾತ
ಒಂದು ಕಾಲು ಒಳಗೆ ಒಂದು ಕಾಲು ಹೊರಗೆ	ಗಡಿಬಿಡಿಯಲ್ಲಿರುವಿಕೆ, ಅವಸರ
ಒಂದು ಕೈ ನೋಡು	ಸೇಡು ತೀರಿಸಿಕೊಳ್ಳು, ಪ್ರಯತ್ನಪಡು
ಒಂದೇ ಕಣ್ಣಲ್ಲಿ ಅಳು	ನೋವು ಅನುಭವಿಸು, ಸಂಕಟಪಡು
ಒಂದೇ ದೋಣಿಯಲ್ಲಿ ತೇಲು	ಸಮಾನ ಸ್ಥಿತಿ
ಒಗ್ಗರಣೆ ಹಾಕು	ಹೆಚ್ಚಿಸು, ಹೆಚ್ಚಾಗುವಂತೆ ಮಾಡು, ನಡುವೆ ಮಾತನಾಡು
ಒಡಕು ಬಾಯಿ	ರಹಸ್ಯವನ್ನು ಕಾಪಾಡದವ
ಒಡಕು ಹುಟ್ಟು	ಒಗ್ಗಟ್ಟಿಲ್ಲವಾಗು
ಒಡೆದ ಕನ್ನಡಿ	ಸರಿಪಡಿಸಲು ಆಗದ 
ಒಡೆದ ಮನೆ	ಪರಸ್ಪರ ಬೇರೆಯಾದ ಅಣ್ಣ ತಮ್ಮಂದಿರು, ಪ್ರತ್ಯೇಕತೆ
ಒಡೆದ ಹಾಲು	ವಿಶ್ವಾಸ ಕಳೆದುಹೋಗು
ಒಣಪಾಂಡಿತ್ಯ	ಕೆಲಸಕ್ಕೆ ಬಾರದ ಜಾಣ್ಮ
ಒಣ ರಗಳೆ	ವ್ಯರ್ಥವಾದ ಕಲಾಪ
ಒಣ ವೇದಾಂತ	ಕೆಲಸಕ್ಕೆ ಬಾರದ ವಿಷಯ
ಒಣ ಹರಟೆ	ಉಪಯೋಗವಿಲ್ಲದ ಮಾತು, ಗೊಡ್ಡು ಹರಟೆ
ಒಪ್ಪಿಸಿಕೊಳ್ಳು	ಸ್ವೀಕರಿಸು
ಒರೆಗೆ ಹಚ್ಚು	ಪರೀಕ್ಷಿಸು
ಒಳಗಣ್ಣು	ಅಂತರಂಗ, ಮನಸ್ಸಿನಿಂದ ನೋಡುವುದು
ಒಳಗೆ ಹಾಕಿಕೊಳ್ಳು	ತನ್ನ ಗುಂಪಿಗೆ ಸೇರಿಸಿಕೊಳ್ಳುವುದು
ಓಂ ಪ್ರಥಮ	ಮೊತ್ತಮೊದಲು
ಓನಾಮ	ಆರಂಭ, ಮೊದಲು ಮಾಡು
ಓಟಕೀಳು	ಓಡಿಹೋಗು, ಪಲಾಯನ ಮಾಡು
ಓಲೆಭಾಗ್ಯ	ಮುತ್ತೈದೆಯಾಗಿರುವುದು
ಔಷಧಕ್ಕೂ ಇಲ್ಲದಿರು	ಪೂರಾ ಖಾಲಿಯಾಗಿರು
ಕಂಕಣ ಕೂಡಿಬರು	ಮದುವೆಯ ಯೋಗ ಬರುವುದು
ಕಂಕಣ ತೊಡು	ನಿರ್ಧರಿಸು, ಸಂಕಲ್ಪಮಾಡು
ಕಂಕಣ ಬಲ	ಮದುವೆಯ ಯೋಗ
ಕಂಚಿನ ಧ್ವನಿ	ದೊಡ್ಡ ಧ್ವನಿ, ದೊಡ್ಡ ಗಂಟಲು
ಕಂಠದಾನ ಮಾಡು	ಹಿನ್ನೆಲೆಯಲ್ಲಿ ಧ್ವನಿ ನೀಡು
ಕಂಠ ಬಿಗಿದು ಬರು	ದುಃಖದಲ್ಲಿರು, ಮಾತನಾಡಲು ಕಷ್ಟವಾಗು
ಕಂಠಶೋಷಣೆ ಮಾಡಿಕೊಳ್ಳು	ವ್ಯರ್ಥವಾಗಿ ಮಾತನಾಡು
ಕಂತೆ ಒಗೆ	ಸತ್ತು ಹೋಗು, ಮರಣಿಸು
ಕಂತೆ ಪುರಾಣ	ಅರ್ಥವಿಲ್ಲದ ವಿಚಾರ
ಕಂಬಿ ಕೀಳಿಸು	ಓಡಿಸು, ಖಾಲಿ ಮಾಡಿಸು
ಕಂಬಿ ಕೀಳು	ಓಡಿಹೋಗು, ಪರಾರಿಯಾಗು
ಕಂಬಿಯಿಲ್ಲದೇ ರೈಲು ಬಿಡು	ಸುಳ್ಳು ಹೇಳುವುದು
ಕಂಭಸುತ್ತು	ವ್ಯರ್ಥವಾಗಿ ಕೆಲಸ ಮಾಡು
ಕಚ್ಚೆ ಬಿಗಿ	ಸಿದ್ಧನಾಗು
ಕಚ್ಚೆಹರುಕ	ಕಾಮುಕ, ವ್ಯಭಿಚಾರಿ
ಕಜ್ಜಾಯ ನೀಡು	ಹೊಡೆ, ಏಟು ನೀಡು
ಕಟಕಟೆ ಹತ್ತಿಸು	ಕೋರ್ಟಿಗೆ ಎಳೆ
ಕಟ್ಟುಕತೆ	ಸುಳ್ಳು ಮಾತುಗಳು
ಕಟ್ಟುಪಾಡು	ನಿಯಮ, ನಿರ್ಭಂಧ
ಕಟ್ಟು ಬೀಳು	ನಿರ್ಬಂಧಕ್ಕೆ ಒಳಗಾಗು
ಕಟ್ಟೆಪುರಾಣ	ಹಾಳು ಹರಟೆ
ಕಡತ ಬಿಚ್ಚು	ಹಿಂದಿನ ವಿಚಾರಗಳನ್ನು ಕುರಿತು ಮಾತನಾಡುವುದು
ಕಡಿವಾಣ ಹಾಕು	ನಿಯಂತ್ರಿಸು
ಕಡೆಗಣ್ಣಲ್ಲಿ ಕಾಣು	ನಿರ್ಲಕ್ಷಿಸು, ಕೀಳಾಗಿ ನೋಡು
ಕಡ್ಡಿ ಆಡಿಸು	ಕೆಲಸವನ್ನು ಕೆಡಿಸು
ಕಡ್ಡಿ ತುಂಡಾಗಿಸು	ನಿರ್ದಾಕ್ಷಿಣ್ಯವಾಗಿ ಮಾತನಾಡು
ಕಡ್ಡಿಮುರಿದ ಹಾಗೆ ಹೇಳು	ನಿಷ್ಟುರವಾಗಿ ಹೇಳು
ಕಡ್ಡಿ ಹಚ್ಚು	ಎರಡು ಬಗೆ, ತೊಂದರೆ ನೀಡು
ಕಣಕ್ಕಿಳಿ	ಕಾರ್ಯಕ್ಕೆ ಸಿದ್ಧನಾಗು
ಕಣಿಕೇಳು	ಗೊತ್ತಿರುವ ವಿಷಯವನ್ನು ಪದೇಪದೇ ಕೇಳುವುದು
ಕಣ್ಮಟ್ಟು	ಮೋಸ, ವಂಚನೆ
ಕಣ್ಣರಳಿಸು	ಸಂತೋಷಪಡು, ಆನಂದಿಸು
ಕಣ್ಣರಳಿಸಿ ನೋಡು	ಕುತೂಹಲದಿಂದ ನೋಡು
ಕಣ್ಣಿಗೆ ಒತ್ತು	ಹೊಟ್ಟೆಕಿಚ್ಚಾಗು
ಕಣ್ಣಲ್ಲಿ ಕಣ್ಣಿಟ್ಟು ನೋಡು	ಎಚ್ಚರಿಕೆಯಿಂದ ನೋಡು
ಕಣ್ಣಲ್ಲಿ ಜೀವ ಹಿಡಿ	ಭಯಪಡು, ಹೆದರು
ಕಣ್ಣಲ್ಲಿ ರಕ್ತ ಬರು	ಬಹಳ ನೋವಾಗು
ಕಣ್ಣಾಡಿಸು	ಗಮನಿಸು, ಲಕ್ಷಿಸು
ಕಣ್ಣಿಗೆ ಅಂಜನ ಹಾಕಿಕೊಂಡು ಹುಡುಕು	ಗಮನವಿಟ್ಟು ಹುಡುಕು
ಕಣ್ಣಿಗೆ ಒತ್ತಿಕೊಳ್ಳು	ಬಹಳ ಇಷ್ಟಪಡು
ಕಣ್ಣಿಗೆ ಕಣ್ಣು ಹತ್ತು	ನಿದ್ರಿಸು
ಕಣ್ಣಿಗೆ ಬೀಳು	ಮುಂದಾಗಿ ಕಾಣಿಸು
ಕಣ್ಣಿಗೆ ಮಣ್ಣೆರಚು	ಮೋಸಮಾಡು, ವಂಚಿಸು
ಕಣ್ಣಿಗೆ ಹಬ್ಬ	ಬಹಳ ಇಷ್ಟವಾಗುವ ದೃಶ್ಯ
ಕಣ್ಣಿಡು	ಗಮನಿಸು, ನಿಗಾವಹಿಸು
ಕಣ್ಣಿನಿಂದ ಕೆಂಡಕಾರು	ಬಹಳ ಕೋಪಗೊಳ್ಳು
ಕಣ್ಣೀರಲ್ಲಿ ಕೈತೊಳೆ	ಬಹಳ ಕಷ್ಟದಲ್ಲಿರು
ಕಣ್ಣೀರಿನಲ್ಲಿ ಕೂಳುತಿನ್ನು	ಕಷ್ಟದಲ್ಲಿರು
ಕಣ್ಣೀರು ಒರೆಸು	ಸಮಾಧಾನಿಸು
ಕಣ್ಣೀರು ಕಪಾಳಕ್ಕೆ ಬರು	ಬಹಳ ಕಷ್ಟವಾಗು
ಕಣ್ಣು ಇಂಗಿ ಹೋಗು	ಕುರುಡಾಗು
ಕಣ್ಣು ಒರೆಸು	ಬಾಯಿ ಮಾತಿನಲ್ಲಿ ಸಂತೈಸು
ಕಣ್ಣು ಎಳೆ	ನಿದ್ರೆ ಬರು
ಕಣ್ಣು ಒದ್ದೆಯಾಗು	ದುಃಖಿಸು, ಭಾವೋದ್ರೇಕ
ಕಣ್ಣು ಕಣ್ಣು ಬಿಡು	ಏನೂ ತೋಚದ ಸ್ಥಿತಿ
ಕಣ್ಣು ಕತ್ತಲಿರಿಸು	ಬವಳಿ ಬರು
ಕಣ್ಣು ಕಿವಿಯಿಡು	ಲಕ್ಷಿಸು, ವಿಶೇಷವಾಗಿ ಗಮನಿಸು
ಕಣ್ಣು ಕಿಸಿರಾಗು	ಅಸಹನೆಯುಂಟಾಗುವುದು
ಕಣ್ಣು ಕೀಳು	ದೃಷ್ಟಿಯನ್ನು ಬದಲಿಸು
ಕಣ್ಣು ಕುಕ್ಕು	ಹೊಟ್ಟೆ ಉರಿಯುವಂತೆ ಮಾಡು
ಕಣ್ಣು ಕೆಂಪಗಾಗು	ಕೋಪ ಬರುವುದು
ಕಣ್ಣು ಕೊಡು	ಮಾರ್ಗದರ್ಶನ ಮಾಡು
ಕಣ್ಣುಗುಡ್ಡೆ ಮೆಲಕ್ಕೆ ಹೋಗುವಂತಾಗು	ತುಂಬಾ ಆಯಾಸವಾಗು
ಕಣ್ಣುಗೊಂಬೆ	ತುಂಬಾ ಪ್ರೀತಿಪಾತ್ರ
ಕಣ್ಣು ತಪ್ಪಿಸು	ಇನ್ನೊಬ್ಬರಿಗೆ ಗೊತ್ತಾಗದಂತೆ ಮಾಡು
ಕಣ್ಣು ನೆತ್ತಿಗೆ ಬರು	ಅಹಂಕಾರ, ಗರ್ವ
ಕಣ್ಣು ಬಿಡು	ಕೋಪದಿಂದ ನೋಡು, ಏಳಿಗೆ ಹೊಂದು
ಕಣ್ಣು ಬೆಳ್ಳಗಾಗು	ಮರಣ ಹೊಂದು
ಕಣ್ಣು ಬೇನೆ	ಹೊಟ್ಟೆಕಿಚ್ಚು
ಕಣ್ಣು ಮಿಟುಕಿಸು	ಸನ್ನೆ ಮಾಡು
ಕಣ್ಣು ಮುಚ್ಚು	ಮರಣಹೊಂದು
ಕಣ್ಣುರಿ	ಅಸೂಯೆ, ಹೊಟ್ಟೆಕಿಚ್ಚು
ಕಣ್ಣು ಹಾಕು	ಕೆಟ್ಟ ರೀತಿಯಲ್ಲಿ ನೋಡು
ಕಣ್ಣು ಹಾಯಿಸು	ನೋಡು, ಗಮನಿಸು
ಕಣ್ಣು ಹೊಡೆ	ಸನ್ನೆ ಮಾಡು
ಕಣ್ಣೆತ್ತಿನೋಡು	ಗಮನಿಸು
ಕಣ್ಣೆರಸು	ಸಮಾಧಾನ ಮಾಡು
ಕಣ್ಮಣಿ	ಪ್ರೀತಿಯ ವಸ್ತು, ವ್ಯಕ್ತಿ
ಕತೆ ಮುಗಿ	ಸಾಯು, ಅಂತ್ಯಕಾಣು
ಕತ್ತರಿ ಪ್ರಯೋಗ	ಬೇಡವಾದುದನ್ನು ತೆಗೆದುಹಾಕುವುದು
ಕತ್ತರಿ ಹಾಕು	ಮಾಡುವ ಕೆಲಸದಲ್ಲಿ ಅಡ್ಡಿ ಮಾಡು
ಕತ್ತಲೆ ಮನೆ	ಜೈಲು
ಕತ್ತಿ ಎತ್ತಿ ಕಟ್ಟು	ಯುದ್ಧಕ್ಕೆ ಸಿದ್ಧತೆ ಮಾಡು
ಕತ್ತಿನ ತನಕ ಇರು	ಬಹಳ ದ್ವೇಷ
ಕತ್ತಿ ಮಸೆ	ದ್ವೇಷ ಸಾಧಿಸು
ಕತ್ತೆ ಕಾಯು	ಸೋಮಾರಿತನ
ಕತ್ತೆಚಾಕರಿ	ಬಹಳಷ್ಟು ಕೆಲಸ
ಕತ್ತೆ ಬಾಲ ಹೋಗು	ನಷ್ಟವಿಲ್ಲದಿರು
ಕಥೆಯಾಗು	ದೊಡ್ಡ ವಿಷಯವಾಗು
ಕನಸಿನ ಗಂಟು	ಅಸಾಧ್ಯವಾದ ವಿಷಯ
ಕನಸಿನ ಗೋಪುರ	ಕಲ್ಪನಾಲೋಕ
ಕನಸು ಕಾಣು	ಕಲ್ಪಿಸಿಕೊಳ್ಳುವುದು
ಕನ್ನಡಿಯೊಳಗಿನ ಗಂಟು	ಕೈಗೆ ಸಿಗದ ವಸ್ತು
ಕನ್ಯಾಸೆರೆ ಬಿಡಿಸು	ಮಗಳ ಮದುವೆ ಮಾಡಿಸು
ಕಪಾಳ ಮೋಕ್ಷ	ಕೆನ್ನಗೆ ಹೊಡೆ
ಕಪಿಮುಷ್ಟಿ	ಬಿಗಿಯಾದ ಹಿಡಿತ
ಕಪಿಸೇನೆ	ಗದ್ದಲ ಮಾಡುವ ಮಕ್ಕಳ ಗುಂಪು
ಕಪ್ಪುಹಣ	ತೆರಿಗೆ ವಂಚಿಸಿ ಸಂಗ್ರಹಿಸಿದ ಹಣ
ಕಬ್ಬಿಣದ ಕಡಲೆ	ಬಹಳ ಕಠಿಣ ವಿಷಯ
ಕರಟು ಬೀಳು	ಬೆಳವಣಿಗೆ ನಿಂತು ಹೊಗು
ಕರುಳಿಗೆ ಕೊಳ್ಳಿ ಇಡು	ಬಹಳ ಕಷ್ಟಕೊಡು, ನೋವುಂಟು ಮಾಡು
ಕರುಳಿನ ಮೇಲೆ ಬರೆ ಹಾಕು	ದುಃಖ ನೀಡು
ಕರುಳಿನಲ್ಲಿ ಕತ್ತರಿ ಆಡಿಸು	ಕಷ್ಟ ಕೊಡು, ನೋವು ನೀಡು
ಕರುಳಿನ ಕುಡಿ	ಸ್ವಂತ ಸಂತಾನ
ಕರುಳು ಕತ್ತರಿಸು	ತುಂಬ ಯಾತನೆ ನೀಡು
ಕರುಳು ಕರಗಿಸು	ಮರುಕವನ್ನುಂಟು ಮಾಡು
ಕರುಳು ಕಿತ್ತುಬರು	ಬಹಳ ಯಾತನೆಯಾಗು
ಕರುಳು ಚುರುಕ್ ಅನ್ನು	ಸಂಕಟವಾಗು
ಕರುಳು ಬಳ್ಳಿ	ರಕ್ತ ಸಂಬಂಧ
ಕರುಳು ಹಿಂಡು	ಬಹಳ ಸಂಕಟವಾಗು
ಕರ್ಮಕಾಂಡ	ಕೆಟ್ಟಕೆಲಸಗಳ ಸರಣಿ
ಕಲ್ಲು ಕರಗು	ದುಷ್ಟನೂ ಸಹ ಕರುಣೆ ತೋರುವುದು
ಕಲ್ಲು ಗುದ್ದಿ ನೀರು ತರಿಸು	ಪರಿಶ್ರಮದ ಕೆಲಸ ಮಾಡುವುದು
ಕಲ್ಲು ಮನಸ್ಸು	ಕಠಿಣ ಮನಸ್ಸು
ಕಲ್ಲು ಮುಳ್ಳು	ಕಠಿಣ ಇರುವುದು
ಕಲ್ಲು ಹಾಕು	ಹಾಳು ಮಾಡು, ಕೆಡಿಸು
ಕಲ್ಲೆದೆ	ಕಠಿಣ ಮನಸ್ಸು
ಕವಳ ಕತ್ತರಿಸು	ಬಿಟ್ಟಿ ಊಟ ಮಾಡು
ಕಸದ ಬುಟ್ಟಿಗೆ ಹಾಕು	ಅಲಕ್ಷಿಸು
ಕಹಳೆ ಬಾಯಿ	ಎಲ್ಲರೆದುರು ಹೇಳುವುದು
ಕಳಸ ಇಡು	ಶೋಭಿಸುವಂತೆ ಮಾಡು
ಕಳ್ಳಗಂಟು	ವಂಚನೆಯಿಂದ ಸಂಗ್ರಹಿಸಿದ ಹಣ
ಕಳ್ಳದಾರಿ	ಗುಪ್ತದಾರಿ
ಕಳ್ಳನೆವ	ಸುಳ್ಳು ಕಾರಣ
ಕಳ್ಳ ವ್ಯಾಪಾರ	ಮೋಸದ ವ್ಯಾಪಾರ
ಕಳ್ಳ ಸಾಕ್ಷಿ	ಸುಳ್ಳು ಸಾಕ್ಷಿ
ಕಳ್ಳ ಹೆಜ್ಜೆ	ಯಾರಿಗೂ ಗೊತ್ತಾಗದಂತೆ ನಡೆಯುವುದು
ಕಾಕಾ ಹಿಡಿ	ಬೇರೆಯವನನ್ನು ಹೊಗಳಿ ಕೆಲಸ ಸಾಧಿಸುವುದು
ಕಾಗಕ್ಕ ಗುಬ್ಬಕ್ಕನ ಕಥೆ	ಸುಳ್ಳು ಕಥೆ
ಕಾಗೆ ಬಳಗ	ಹೆಚ್ಚು ಜನ ಸಂಬಂಧಿಗಳು
ಕಾಜಿ ನ್ಯಾಯ	ಎಲ್ಲರಿಗೂ ಸಮಾಧಾನ ನೀಡುವ ನ್ಯಾಯ
ಕಾಟಾಚಾರ	ಬೇಕಾಬಿಟ್ಟಿ ಕೆಲಸ
ಕಾಡುಪಾಲು ಮಾಡು	ಅನಾಥರನ್ನಾಗಿ ಮಾಡು
ಕಾಡು ಬೆಳದಿಂಗಳು	ನಿರರ್ಥಕವಾದುದು
ಕಾಡು ಹರಟೆ	ಕೆಲಸಕ್ಕೆ ಬಾರದ ಮಾತು
ಕಾಮಧೇನು	ಕೇಳಿದ್ದನ್ನು ಕೊಡುವವ
ಕಾಮಾಲೆ ಕಣ್ಣು	ಸಂದೇಹದ ದೃಷ್ಟಿ
ಕಾರಸ್ಥಾನ ಮಾಡು	ಪಿತೂರಿ ಮಾಡು
ಕಾಲ ಕೂಡಿಬರು	ಒಳ್ಳೆಯ ಸಮಯ ಬರುವುದು
ಕಾಲಮೇಲೆ ಕಾಲು ಹಾಕು	ಕಷ್ಟವಿಲ್ಲದೇ ಇರು, ಆರಾಮವಾಗಿರು
ಕಾಲಲ್ಲಿ ಚಕ್ರವಿರು	ಅಲೆಮಾರಿಯಾಗಿರುವುದು
ಕಾಲವಾಗು	ಮರಣ ಹೊಂದು
ಕಾಲ ಹಾಕು	ಜೀವನ ಸಾಗಿಸು
ಕಾಲಿಗೆ ಬುದ್ದಿಹೇಳು	ಪಲಾಯನ ಮಾಡು, ಓಡಿ ಹೋಗು
ಕಾಲಿಡು	ಆರಂಭವಾಗು
ಕಾಲು ಕಸ	ಬೆಲೆಯಿಲ್ಲದ
ಕಾಲು ಕೀಳು	ಪಲಾಯನ ಮಾಡು, ಸ್ಥಳ ಖಾಲಿ ಮಾಡು
ಕಾಲು ಕೆದರು	ಜಗಳಕ್ಕೆ ನಿಲ್ಲು
ಕಾಲು ಚಾಚು	ಸುಖವಾಗಿರು
ಕಾಲು ಜಾರು	ಕೆಟ್ಟದಾರಿ ಹಿಡಿ
ಕಾಲು ಮುರಿದು ಕೈಗೆ ಕೊಡು	ಶಿಕ್ಷಿಸು, ದಂಡಿಸು
ಕಾಲು ಸುಟ್ಟ ಬೆಕ್ಕು	ಬುದ್ದಿ ಕಲಿ
ಕಾಲು ಹಾಕು	ನಡುವೆ ಪ್ರವೇಶಿಸು
ಕಾಲು ಹಿಡಿ	ಶರಣಾಗು, ಬೇಡಿಕೊಳ್ಳು
ಕಾಲೂರು	ನೆಲೆನಿಲ್ಲು, ವಾಸಿಸು
ಕಾಸಿಗೆ ಕಾಸು ಗಂಟು ಹಾಕು	ಜಿಪುಣತನ
ಕಿಡಿ ಕಾರು	ಅತಿಯಾಗಿ ಕೋಪಮಾಡಿಕೊಳ್ಳು
ಕಿಡಿಕಿಡಿಯಾಗು	ಅತಿಯಾಗಿ ಕೋಪಿಸಿಕೊಳ್ಳು
ಕೀರಿಟಪ್ರಾಯವಾಗು	ಶೋಭೆ ತರುವಂತಿರು
ಕಿರುಬೆರಳಲ್ಲಿ ಕುಣಿಸು	ಹೇಳಿದಂತೆ ಕೇಳುವ ಹಾಗೆ ಮಾಡು
ಕಿವಿ ಉದ್ದವಾಗು	ಕದ್ದು ಕೇಳಲು ಉತ್ಸುಕನಾಗು
ಕಿವಿ ಊದು	ಚಾಡಿ ಹೇಳು
ಕಿವಿ ಕಚ್ಚು	ಬೇರೆಯವರ ಬಗ್ಗೆ ಚಾಡಿ ಹೇಳು
ಕಿವಿಕೊಟ್ಟು ಕೇಳು	ಗಮನವಿಟ್ಟು ಕೇಳು
ಕಿವಿ ಕೊಡು	ಗಮನವಿಟ್ಟು ಕೇಳು
ಕಿವಿಗೆ ಬೀಳು	ಪ್ರಯತ್ನವಿಲ್ಲದೇ ಕೇಳಿಬರುವುದು
ಕಿವಿಗೆ ಹಾಕಿಕೊಳ್ಳು	ಕೇಳಿಸಿಕೊಳ್ಳು
ಕಿವಿಗೆ ಹಾಕು	ತಿಳಿಸು
ಕಿವಿ ಚುಚ್ಚು	ಚಾಡಿ ಹೇಳು
ಕಿವಿ ಚುರುಕಾಗು	ಉತ್ಸುಕನಾಗು
ಕಿವಿ ತುಂಬು	ಚಾಡಿ ಹೇಳು
ಕಿವಿ ನೆಟ್ಟಗಾಗು	ಕೇಳಲು ಕುತೂಹಲವಾಗು
ಕಿವಿಮಾತು	ಗುಟ್ಟಿನಿಂದ ಕೂಡಿದ ಮಾತು
ಕಿವಿಯ ಮೇಲೆ ಹಾಕಿಕೊಳ್ಳು	ಗಮನವಿಟ್ಟು ಕೇಳು
ಕಿವಿಹಿಂಡು	ಚಾಡಿ ಹೇಳಿ ಮನಸ್ಸು ತಿರುಗಿಸು
ಕಿಮ್ಮಿಂದೆ	ಇಕ್ಕಟ್ಟಾದ ಪ್ರದೇಶ
ಕಿಸುಗಾಲು ಹಾಕು	ಆಯಾಸ ಹೊಂದು
ಕಿಸುಬಾಯಿದಾಸ	ಮೂರ್ಖ, ದಡ್ಡ
ಕಿಸೆಗೆ ಹಾಕಿಕೊಳ್ಳು	ತನ್ನ ವಶ ಮಾಡಿಕೊಳ್ಳು
ಕೀಲಿ ಕೊಡು	ಪ್ರೇರೇಪಿಸು, ಅವಕಾಶ ನೀಡು
ಕುಂಕುಮ ಬಲ	ಮುತ್ತೈದೆತನ
ಕುಂಕುಮ ಹಚ್ಚು	ಕನೈಯನ್ನು ಮದುವೆಗೆ ನಿಶ್ಚಿತಗೊಳಿಸು
ಕುಂಟು ನೆಪ	ತೋರಿಕೆಯ ಕಾರಣ
ಕುಂಭಕರ್ಣ	ಹೆಚ್ಚು ನಿದ್ದೆ ಮಾಡುವವನು
ಕುಟುಕು ಜೀವ	ಆಗಲೋ ಈಗಲೋ ಸಾಯುವವ
ಕುಠಾರ ಪ್ರಾಯ	ಎಲ್ಲರಿಗೂ ಮನಸ್ಸು ನೋಯುವಂತೆ ಮಾಡುವವ
ಕುಡಿದ ನೀರು ಅಲ್ಲಾಡು	ಯಾವುದೇ ರೀತಿಯ ತೊಂದರೆ ಆಗದಿರು
ಕುತ್ತಿಗೆ ಕೊಯ್ಯು	ಮೋಸಮಾಡು
ಕುತ್ತಿಗೆಗೆ ಕಟ್ಟಿಕೊಳ್ಳು	ಜವಾಬ್ದಾರಿ ಹೊರು
ಕುತ್ತಿಗೆಗೆ ಬರು	ಸಂಕಟ ಬರು
ಕುತ್ತಿಗೆಗೆ ಬೀಳು	ಜವಾಬ್ದಾರಿ ಹೊರು
ಕುತ್ತಿಗೆ ವರೆಗೆ ಇರು	ಬಹಳ ದ್ವೇಷ ತುಂಬಿರು
ಕುತ್ತಿಗೆ ಮೇಲೆ ಕೂರು	ಬಹಳ ಒತ್ತಾಯ ಮಾಡು
ಕುದುರೆಯ ಕೊಂಬು	ಕಾಣಲು ಅಸಾಧ್ಯವಾದುದು, ಕಲ್ಪಿತವಾದುದು
ಕುಬೇರ	ಆಗರ್ಭ ಶ್ರೀಮಂತ
ಕುಬೇರನ ಸಂಪತ್ತು	ಬಹಳಷ್ಟು ಸಂಪತ್ತು
ಕುರಿ ಕೋಣ ಬೀಳು	ಬಹಳ ಕಷ್ಟಕರವಾಗು
ಕುರುಡಾಗು	ತಿಳಿವಳಿಕೆಯಿಲ್ಲದಿರು.
ಕುರುಡು ನಂಬಿಕೆ	ಮೂಢನಂಬಿಕೆ
ಕುರುಡೇಟು	ಗುರಿಯಿಲ್ಲದೇ ಹೊಡೆದ ಪೆಟ್ಟು
ಕುರುವಿನ ಮೇಲೆ ಬೊಕ್ಕೆ ಏಳು	ಸತತವಾಗಿ ಕಷ್ಟಗಳು ಬರುವುದು
ಕುಲಗೆಡು	ನಾಶವಾಗು, ಹಾಳಾಗು
ಕೂತು ಮಲಗು	ತಾಳ್ಮೆ ವಹಿಸು
ಕೂದಲು ನೆಟ್ಟಗಾಗು	ಆಶ್ಚರ್ಯವಾಗು, ವಿಸ್ಮಯವಾಗು
ಕೂದಲು ಹಣ್ಣಾಗು	ವಯಸ್ಸಾಗು
ಕೂದಲೆಳೆಯಷ್ಟು	ಸ್ವಲ್ಪ ಬಹಳ ಕಡಿಮೆ
ಕೂಪ ಮಂಡೂಕ	ಸೀಮಿತ ಬುದ್ಧಿಯವನು
ಕೂಳಿಗೆ ಕೇಡು	ಸೋಮಾರಿ
ಕೆಂಡಕಾರು	ಬಹಳ ಕೋಪಮಾಡಿಕೊಳ್ಳು
ಕೆಚ್ಚಲು ಕಚ್ಚಿದ ಉಣ್ಣೆ	ಸುಖ ಇದ್ದರೂ ಅದನ್ನು ಅನುಭವಿಸದಿರುವಿಕೆ
ಕೆಚ್ಚಲು ಕೊಯ್ಯು	ದುರಾಸೆಗೊಳಗಾಗುವುದು, ಪೂರ್ಣ ನಾಶಗೊಳಿಸುವುದು
ಕೆನ್ನೆ ಕೆಂಪಾಗು	ನಾಚಿಕೊಳ್ಳು, ಲಜ್ಜೆಗೀಡಾಗು
ಕೆಸರಿನಲ್ಲಿ ನೆಟ್ಟ ಕಂಬ	ಅಸ್ಥಿರವಾದುದು
ಕೈಯಿಡು	ಆರಂಭ ಮಾಡು
ಕೈಯೆತುತಿ	ಸಹಮತ ಸೂಚಿಸು, ಒಪ್ಪು
ಕೈಯೊಡ್ಡು	ಬೇಡು, ಕೇಳು
ಕೈಕಚ್ಚು	ನಷ್ಟವಾಗು, ಕಳೆದುಕೊಳ್ಳು
ಕೈ ಕಟ್ಟಿ ಕೂಡು	ನಿರುಪಾಯನಾಗು
ಕೈ ಕಟ್ಟಿನಿಲ್ಲು	ಸಿದ್ದನಾಗು
ಕೈ ಕಾಯು	ರಕ್ಷಣೆ ನೀಡು
ಕೈ ಕಾಲು ಕಟ್ಟಿಕೊಳ್ಳು	ಶರಣಾಗು, ಬೇಡು
ಕೈ ಕಾಲು ಗಟ್ಟಿಯಾಗಿರು	ಬಹಳ ಶಕ್ತಿಯಿರು
ಕೈ ಕಾಲುಗೆಡು	ಧೈರ್ಯಗುಂದು, ಎದೆಗೆಡು, ಕಂಗಾಲಾಗು
ಕೈ ಕಾಲು ನಡುಗು	ಭಯವಾಗು, ವಯಸ್ಸಾಗು
ಕೈ ಕಾಲು ಬಿಡು	ಕಂಗಾಲಾಗು, ಭಯಹೊಂದು
ಕೈ ಕಾಲು ಬೀಳು	ನಿಶ್ಯಕ್ತಿ ಹೊಂದು
ಕೈ ಕಾಲು ಹಿಡಿ	ಅಂಗಲಾಚು, ದೈನ್ಯದಿಂದ ಬೇಡು
ಕೈ ಕುದುರು	ಪಳಗು, ಪರಿಚಿತನಾಗು
ಕೈ ಕೆಲಸ	ಕಿಸೆ ಕತ್ತರಿಸುವುದು, ಕಳ್ಳತನ ಮಾಡುವುದು
ಕೈ ಕೆಸರಾಗು	ಶ್ರಮಪಡು, ದುಡಿ
ಕೈ ಕೊಡು	ಮೋಸ ಮಾಡು
ಕೈ ಖರ್ಚು	ಚಿಲ್ಲರೆ ಖರ್ಚು
ಕೈ ಗಂಟು	ಗುಪ್ತವಾಗಿ ಇರಿಸಿದ ಹಣ
ಕೈಗನ್ನಡಿ	ನಿಖರವಾದ ಮಾರ್ಗದರ್ಶಿ
ಕೈಗೂಡು	ನೆರವೇರು, ಸಿದ್ಧಿಸು
ಕೈಗೆ ಕೈ ಹತ್ತು	ಜಗಳವಾಗು
ಕೈಗೆಟುಕು	ವಶವಾಗು, ಕೈಗೆ ಸಿಗು
ಕೈಗೆ ಬಾಯಿಗೆ ಬರು	ಬಹಳ ಸುಸ್ತಾಗು
ಕೈಚಳಕ	ಚಾತುರ್ಯ, ಚಮತ್ಕಾರ
ಕೈಜಾರು	ಬೇರೆಯವರ ವಶವಾಗು
ಕೈ ತಪ್ಪು	ಬೇರೆಯವರ ವಶವಾಗು
ಕೈ ತೊಳೆದುಕೊಳ್ಳು	ಜವಾಬ್ದಾರಿ ಕಳೆದುಕೊ
ಕೈ ತೋರಿಸು	ಸಾಮರ್ಥ್ಯ ತೋರಿಸು
ಕೈನೋಡು	ಶಕ್ತಿಯನ್ನು ಪ್ರದರ್ಶಿಸು
ಕೈಬರಿದಾಗು	ಎಲ್ಲವನ್ನು ಕಳೆದುಕೊಳ್ಳು
ಕೈ ಬಿಗಿ ಹಿಡಿ	ಜಿಪುಣತನ ತೋರಿಸು
ಕೈ ಬಿಟ್ಟು ಹೋಗು	ದೂರವಾಗು
ಕೈಬಿಡು	ಸಹಾಯ ಮಾಡುವುದನ್ನು ಬಿಡು
ಕೈ ಬೆಚ್ಚಗೆ ಮಾಡು	ಲಂಚ ಕೊಡು
ಕೈಮೀರು	ನಿಯಂತ್ರಣ ತಪ್ಪು
ಕೈಲಾಗು	ಸಾಧ್ಯವಾಗು, ಸಮರ್ಥನಾಗು
ಕೈಲಾಸವಾಸ	ಮರಣಹೊಂದು
ಕೈ ಸಡಿಲ ಬಿಡು	ಧಾರಾಳವಾಗಿ ಖರ್ಚು ಮಾಡು
ಕೈಸೋಲು	ಬಡವನಾಗು, ಎಲ್ಲವನ್ನು ಕಳೆದುಕೊಳ್ಳು
ಕೈ ಹತ್ತು	ಸಿದ್ದಿಸು, ವಶವಾಗು
ಕೈ ಹಾಕು	ಆರಂಭಿಸು, ಪ್ರಾರಂಭ ಮಾಡು
ಕೈ ಹಿಡಿ	ಕಾಪಾಡು, ರಕ್ಷಣೆ ನೀಡು
ಕೊಂಬು ಬರು	ಅಹಂಕಾರ ಪಡು
ಕೊಕ್ಕೆ ಹಾಕು	ಅಡ್ಡಿ ಮಾಡು
ಕೊನೆಯುಸಿರೆಳೆ	ಮರಣಿಸು, ಸಾಯು
ಕೊರಳಿಗೆ ಬರು	ಪ್ರಾಣಾಪಾಯ ಬರು
ಕೊಳೆಹಾಕು	ತಡೆದು ನಿಲ್ಲಿಸು, ಮುಂದುವರಿಯದಂತೆ ತಡೆ
ಕೋಡು ಬರು	ಅಹಂಕಾರ ಬರು
ಕೋಲೆ ಬಸವ	ಹೇಳಿದ್ದಕ್ಕೆಲ್ಲ ತಲೆ ಅಲ್ಲಾಡಿಸುವವ
ಕೋಳಿ ಜಗಳ	ಕ್ಷುಲ್ಲಕ ಜಗಳ, ಹುಡುಗಾಟಿಕೆಯ ಜಗಳ
ಕೋಳಿ ನಿದ್ದೆ	ಸ್ವಲ್ಪ ನಿದ್ದೆ
ಕೋಳಿ ಸಂತಾನ	ಬಹಳ ಮಕ್ಕಳಿರುವುದು
ಕ್ಷೌರವಾಗು	ನಷ್ಟವಾಗು, ಕಳೆದುಹೋಗು
ಖಜಾನೆ ತುಂಬು	ಲಾಭವಾಗು, ಹೊಟ್ಟೆ ತುಂಬು
ಖೆಡ್ಡಕ್ಕೆ ಹಾಕು	ಮೋಸ ಮಾಡು, ಬಲಿಬೀಳಿಸು
ಖೋಟಾ ನಾಣ್ಯ	ಬೆಲೆಯಿಲ್ಲದವ
ಗಂಜಿ ಕುಡಿ	ಬಡತನದ ಜೀವನ ನಡೆಸು
ಗಂಟಲು ಒಣಗು	ನೀರಡಿಕೆಯಾಗುವುದು
ಗಂಟಲು ಕೊಯ್ಯು	ವಿಶ್ವಾಸಕ್ಕೆ ಧಕ್ಕೆ ತರು
ಗಂಟಲು ತುಂಬಿ ಬರು	ಭಾವಾವೇಶಕ್ಕೆ ಒಳಗಾಗು
ಗಂಟಲು ದೊಡ್ಡದು ಮಾಡು	ಜೋರಾಗಿ ಮಾತನಾಡು
ಗಂಟಲು ಬಿಗಿ	ಭಾವೋದ್ರೇಕದಿಂದ ಕೂಡಿರು
ಗಂಟರು ಹರಿದುಕೊಳ್ಳು	ವ್ಯರ್ಥವಾಗಿ ಬಹಳ ಹೊತ್ತು ತಿಳಿ ಹೇಳುವುದು
ಗಂಟರು ಹಿಡಿ	ಮಾತನಾಡಲು ಆಗದ ಸ್ಥಿತಿ
ಗಂಟು ಕತ್ತರಿಸು	ಹಣವನ್ನು ಅಪಹರಿಸು
ಗಂಟು ಕರಗು	ಕೂಡಿಟ್ಟ ಹಣವೆಲ್ಲ ಖರ್ಚಾಗು
ಗಂಟು ತಿನ್ನು	ಮೋಸ ಮಾಡು
ಗಂಟು ಬೀಳು	ಅಂಟಿಕೊಳ್ಳು, ಬಿಡದೇ ಹಿಂಬಾಲಿಸು
ಗಂಟುಮಾಡು	ಸಂಪಾದಿಸು
ಗಂಟು ಮುಖ	ಕೋಪದಿಂದ ಕೂಡಿದ ಮುಖ
ಗಂಟು ಮುಳುಗಿಸು	ಸಾಲವನ್ನು ಮರಳಿ ಕೊಡದಿರು
ಗಂಟು ಹಾಕು	ಮದುವೆ ಮಾಡು, ಜೊತೆಗೂಡಿಸು, ಸಂಗ್ರಹಿಸು
ಗಂಡು ಹೊಡೆ	ಲಪಟಾಯಿಸು, ಕಳ್ಳತನ ಮಾಡು
ಗಂಡುಬೀರಿ	ದಿಟ್ಟೆ, ಗಂಡು ಸ್ವಭಾವದವಳು
ಗಂಡೆದೆ	ಧೈರ್ಯ, ಎದೆಗಾರಿಕೆ
ಗಂಧವಿಲ್ಲದಿರು	ತಿಳಿವಳಿಕೆಯಿಲ್ಲದಿರು
ಗಗನಕುಸುಮ	ಅಸಾಧ್ಯವಾದುದು, ಕೈಗೆಟುಕದ್ದು
ಗಗನಕ್ಕೇರು	ಬೆಲೆ ಹೆಚ್ಚಾಗು
ಗಜಗರ್ಭ	ಬಹಳ ನಿಧಾನದ ಕಾರ್ಯ
ಗಟ್ಟಿ ಕುಳ	ಧನವಂತ, ಶ್ರೀಮಂತ
ಗಟ್ಟಿ ಪಿಂಡ	ಬಲಶಾಲಿ, ಸಾಮಾನ್ಯಕ್ಕೆ ಬಗ್ಗದವನು
ಗಟ್ಟ ಮಾಡು	ಬಾಯಿಪಾಠ ಮಾಡು, ಊರು ಹೊಡೆ
ಗಡಪ್ಪು ಮಾಡು	ಖರ್ಚು ಮಾಡು, ವ್ಯಯ ಮಾಡು
ಗಡ್ಡ ಬೆಳ್ಳಗಾಗು	ವಯಸ್ಸಾಗು, ಮುಪ್ಪು ಬರು
ಗಣೇಶನ ಮದುವೆ	ಆಗದಿರುವ ಕೆಲಸ, ನೆರವೇರದ್ದು
ಗತಿಗಾಣಿಸು	ಮುಗಿಸು, ಪೂರೈಸು
ಗತಿಗೇಡಿ	ನಿರ್ಭಾಗ್ಯ, ದರಿದ್ರ
ಗತಿ ನೆಟ್ಟಗಾಗು	ಒಳ್ಳೆಯ ಸ್ಥಿತಿ ಬರು
ಗರಂ ಆಗು	ಕೋಪ ಮಾಡಿಕೊಳ್ಳು, ಸಿಟ್ಟಾಗು
ಗರಿ ಮೂಡು	ಉತ್ಸಾಹ ಬರು, ಹುರುಪಾಗು
ಗರುಡ ಗಂಬ	ಅಡ್ಡಲಾಗಿ ನಿಂತವನು
ಗಸ್ತು ಕೊಡು	ಮೋಸ ಮಾಡು
ಗಾಡಿ ಬಿಡು	ಹೊರಟು ಹೋಗು
ಗಾಣದೆತ್ತು	ಸತತ ದುಡಿಯುವ ವ್ಯಕ್ತಿ
ಗಾಳ ಹಾಕು	ಆಸೆ ತೋರಿಸು
ಗಾಳಿಗೆ ತೂರು	ನಿರ್ಲಕ್ಷ ಮಾಡು
ಗಾಳಿ ಗೋಪುರ	ಕಲ್ಪನೆ ಮಾಡುವುದು
ಗಾಳಿಪಾಲಾಗು	ವ್ಯರ್ಥವಾಗಿ ಹೋಗುವುದು
ಗಾಳಿ ಬೀಸು	ಸೇವೆ ಮಾಡು, ಪ್ರಭಾವ ಬೀಳು
ಗಾಳಿ ಮಾತು	ಸುಳ್ಳು ಸುದ್ದಿ
ಗಿರಕಿ ಹೊಡೆ	ಅನುತ್ತೀರ್ಣನಾಗು. ಸುಮ್ಮನೆ ಸುತ್ತಾಡು
ಗಿಳಿ ಪಾಠ	ಅರ್ಥವಿಲ್ಲದೆ ಹೇಳುವುದು
ಗಿಳಿ ಹಾಗೆ ಕಾಪಾಡು	ಬಹಳ ಜೋಪಾನ ಮಾಡು
ಗಂಡು ಗೋವಿ	ಸ್ಟೇಚ್ಛೆಯಿಂದ ಬೆಳೆದವನು
ಗುಂಡು ಹಾಕು	ಸರಾಯಿ ಕುಡಿ
ಗುಟ್ಟು ರಟ್ಟಾಗು	ರಹಸ್ಯ ಬಯಲಾಗು
ಗುಡಚಾಪೆ ಎತ್ತು	ಗಂಟು ಮೂಟೆ ಕಟ್ಟಿ ಹೊರಡು
ಗುಡಾರ ಕೀಳು	ಹೊರಟು ಹೋಗು
ಗುಡಿಕಟ್ಟು	ಆನಂದದಿಂದ ಬಾಳು
ಗುಡ್ಡಕ್ಕೆ ಕಲ್ಲು ಹೊರು	ವ್ಯರ್ಥವಾದ ಕೆಲಸ ಮಾಡು
ಗುದಮುರಿಗೆ ಹಾಕು	ಬಹಳ ಶ್ರಮಪಟ್ಟು ಕೆಲಸ ಮಾಡು
ಗುರುಬಲ	ಅದೃಷ್ಟ ಅನುಕೂಲಕರ ಸ್ಥಿತಿ
ಗುರುವಿಗೇ ತಿರುಮಂತ್ರ	ಹೇಳಿದವನಿಗೇ ಪ್ರತಿ ಹೇಳುವುದು
ಗುಳುಂ ಮಾಡು	ಮೋಸ ಮಾಡು, ವಂಚಿಸು
ಗುಳೇ ಹೋಗು	ವಲಸೆ ಹೋಗು, ಸಾಮೂಹಿಕವಾಗಿ ಬೇರೆ ಕಡೆ ಹೋಗಿ ನೆಲೆಸು
ಗುಳ್ಳೆ ನರಿ	ಮೋಸಗಾರ, ವಂಚಕ
ಗೂಬೆ ಕೂರಿಸು	ಅಪವಾದವನ್ನು ಹೊರಿಸು
ಗೂಳಿ	ಅಂಕೆಯಿಲ್ಲದೆ ಚೆನ್ನಾಗಿ ತಿಂದು ಕೊಬ್ಬಿರುವ ವ್ಯಕ್ತಿ
ಗೆದ್ದಲು ಹತ್ತು	ಹಾಳಾಗು, ನಾಶವಾಗು
ಗೆದ್ದೆತ್ತಿನ ಬಾಲ ಹಿಡಿ	ಸಮಯಸಾಧಕತನ
ಗೆರೆ ದಾಟು	ಹೇಳಿದ್ದನ್ನು ಮೀರು
ಗೊಟಕ್ ಅನ್ನು	ಸತ್ತು ಹೋಗು, ಮರಣ ಹೊಂದು
ಗೊಡ್ಡು ಹರಟೆ	ವ್ಯರ್ಥವಾದ ಮಾತುಕತೆ
ಗೋಡೆಗೆ ಕಿವಿಯಿರು	ಕದ್ದು ಕೇಳುವ ವ್ಯಕ್ತಿಯಿರು
ಗೋಣು ಅಲ್ಲಾಡಿಸು	ಅಸಮ್ಮತಿ ಸೂಚಿಸು
ಗೋಣು ಚೆಲ್ಲು	ಸತ್ತು ಹೋಗು, ಮರಣ ಹೊಂದು
ಗೋತ ಹೊಡೆ	ಮರಣ ಹೊಂದು, ಅಸಫಲನಾಗು
ಗೋಮುಖ ವ್ಯಾಘ್ರ	ಮೋಸಗಾರ, ಮುಂದೊಂದು ಹಿಂದೊಂದು ಮಾಡುವವ
ಗೋರಿ ತೋಡಿಕೊಳ್ಳು	ತನ್ನ ನಾಶಕ್ಕೆ ತಾನೇ ಕಾರಣನಾಗು
ಗೋರಿ ಮಾಡು	ನಾಶಮಾಡು, ನಿವಾರಿಸು
ಗೋಲ್‌ಮಾಲ್	ಮೋಸ, ವಂಚನೆ
ಗೋಲಿ ಹೊಡೆ	ನಿರ್ಲಕ್ಷಿಸು, ಗಮನ ಕೊಡದಿರು
ಗೋವಿಂದ	ಮೋಸಮಾಡುವುದು
ಗೋಸುಂಬೆ	ಸಮಯಕ್ಕೆ ತಕ್ಕಹಾಗೆ ಬದಲಾಗುವವ
ಗ್ರಹಚಾರ ಬಿಡಿಸು	ಬುದ್ದಿಕಲಿಸು, ಚೆನ್ನಾಗಿ ಬಯ್ಯು
ಗ್ರಹಣ ಹಿಡಿ	ದಿಕ್ಕುಗೆಡು, ಏನೂ ತೋಚದಂತಿರು
ಘಟ ಬೀಳು	ಸತ್ತು ಹೋಗು, ಮರಣಿಸು
ಘಂಟಾಘೋಷವಾಗಿ ಹೇಳು	ನಿರ್ಧಾರವಾಗಿ ಹೇಳು
ಚಂಡು ಮುರಿ	ಕತ್ತರಿಸು, ಕೊಯ್ಯು
ಚಂದನದ ಗೊಂಬೆ	ಸುಂದರವಾದ ವ್ಯಕ್ತಿ
ಚಕಮಕಿ ಆಗು	ಜಗಳವುಂಟಾಗು, ಮಾತಿಗೆ ಮಾತು ಬೆಳೆ
ಚಕಾರ ತೆಗೆ	ವಿರುದ್ಧವಾಗಿ ಏನನ್ನೂ ಹೇಳದಿರು
ಚಕ್ಕರ್ ಹೊಡೆ	ಗೈರು ಹಾಜರಾಗು
ಚಕ್ರವ್ಯೂಹ	ಇಕ್ಕಟ್ಟಿನ ಸ್ಥಿತಿ
ಚಪ್ಪಡಿ ಹಾಕು	ನಾಶ ಮಾಡು, ಹಾಳು ಮಾಡು
ಚಮಚಾ	ಪೂಸಿ ಹೊಡೆಯುವವ
ಚಮ್ಮಡ ಸುಲಿ	ಶಿಕ್ಷೆ ಕೊಡು
ಚರಮ ಗೀತೆ ಹಾಡು	ಕೊನೆ ಹೇಳು, ಮುಕ್ತಾಯ ಹಾಕು
ಚರ್ವಿತ ಚರ್ವಣ	ಹೇಳಿದ್ದನ್ನೇ ಹೇಳುವುದು
ಚಳಿಬಿಡಿಸು	ಭಯವನ್ನು ಹೋಗಲಾಡಿಸು
ಚಳಿಬಿಡು	ಭಯ ಹೊರಟುಹೋಗುವುದು, ಸಂಕೋಚವಿಲ್ಲದಿರುವುದು
ಚಳ್ಳೆಹಣ್ಣು ತಿನ್ನಿಸು	ಮೋಸ ಮಾಡು, ವಂಚಿಸು
ಚಾಕರಿ ಮಾಡು	ತುಂಬ ಕೆಲಸ ಮಾಡು, ಕೂಲಿ ಮಾಡು
ಚಾಣಕ್ಯ	ತಂತ್ರಗಾರ, ಬುದ್ಧಿವಂತ
ಚಾತಕ ಪಕ್ಷಿಯಂತೆ ಕಾಯು	ಬಹಳ ಕಾಲ ನಿರೀಕ್ಷಿಸು
ಚಾಪೆ ಕೆಳಗೆ ತೂರು	ಅತಿಯಾದ ಬುದ್ದಿವಂತಿಕೆ ತೋರು
ಚಾಪೆ ಹಿಡಿ	ಖಾಯಿಲೆಯಿಂದ ಮಲಗು
ಚಿಗಿತುಕೊಳ್ಳು	ಜೋರಾಗು, ಹೆಚ್ಚು ಮಾತನಾಡು
ಚಿತ್ರಹಿಂಸೆ	ಬಹಳಷ್ಟು ಕಷ್ಟಕೊಡು
ಚಿತ್ರಾನ್ನ ಸ್ಥಿತಿ	ಗತಿಯಿಲ್ಲದ ಸ್ಥಿತಿ
ಚಿದಂಬರ ರಹಸ್ಯ	ಬಿಡಿಸಲಾಗದ ಗುಟ್ಟು
ಚಿನ್ನದ ಕತ್ತಿ	ಬಹಳ ಪ್ರಿಯವಾದುದು
ಚಿನ್ನದ ಗಣಿ	ಆದಾಯದ ಮೂಲ
ಚಿನ್ನದ ಗುಣ	ಉತ್ತಮ ಗುಣ, ಒಳ್ಳೆಯತನ
ಚಿನ್ನದ ಸೂಜಿ	ತುಂಬ ಪ್ರಿಯವಾದುದು, ಬಹಳ ಬೇಕಾದ ವಸ್ತು
ಚುಚ್ಚಿಕೊಡು	ಚಾಡಿ ಹೇಳು
ಚುರುಕು ಮುಟ್ಟಿಸು	ಎಚ್ಚರಿಕೆ ಕೊಡು
ಚುರುಕು ಮೆಣಸಿನಕಾಯಿ	ಚಟುವಟಿಕೆಯಿಂದ ಕೂಡಿರುವವ
ಚೇಳುಕುಟುಕಿದಂತಾಗು	ಅಪಾರ ನೋವುಂಟಾಗು
ಛತ್ರಿ	ಕಿಲಾಡಿ, ಚಾಣಾಕ್ಷ
ಛೇ ಅನ್ನಿಸಿಕೋ	ಅವಮಾನಕ್ಕೆ ಗುರಿಯಾಗು
ಭೂ ಬಿಡು	ಮೇಲೆ ಬೀಳಲು ಹುರಿದುಂಬಿಸು
ಜಂಗು ಹಿಡಿ	ನಿಷ್ಕ್ರಿಯನಾಗು, ಜಡವಾಗು
ಜಂಬದ ಕೋಳಿ	ಆಡಂಬರದ ವ್ಯಕ್ತಿ
ಜಗತ್ತು ಮುಳುಗು	ಪ್ರಳಯವಾಗು, ಸರ್ವನಾಶವಾಗು
ಜಟಾಯು	ವೃದ್ಧ ವ್ಯಕ್ತಿ, ಹಿರಿಯ ವ್ಯಕ್ತಿ
ಜಡಭರತ	ಮಂದಮತಿ, ಬುದ್ದಿಯಿಲ್ಲದವ
ಜನ್ಮ ಜಾಲಾಡು	ವಿಚಾರಿಸಿಕೊಳ್ಳು, ತರಾಟೆಗೆ ತೆಗೆದುಕೊಳ್ಳು
ಜನ್ಮ ನೀಗು	ಜೀವನವನ್ನು ನೂರು
ಜಪ ಮಾಡು	ಒಂದೇ ಸವನೆ ಚಿಂತಿಸು
ಜಾಗಟೆ ಬಾರಿಸು	ಪ್ರಚಾರ ಮಾಡು
ಜಾಗ ಹಿಡಿ	ಮೊದಲೇ ಬಂದು ಕುಳಿತುಕೊಳ್ಳು
ಜಾಡು ಹಿಡಿ	ಸುಳಿವು ಹಿಡಿ, ಪತ್ತೆ ಮಾಡು
ಜಾಣ ಕಿವುಡು	ಕೇಳಿದರೂ ಕೇಳದಂತಿರುವುದು
ಜಾಪಾಳ ಮಾತ್ರೆ ಕೊಡು	ಪಾಠ ಕಲಿಸು, ಬುದ್ದಿ ಕಲಿಸು
ಜಾಲಬೀಸು	ವಂಚಿಸಲು ಯತ್ನಿಸು
ಜಿಗಣೆ	ಗಟ್ಟಿಯಾಗಿ ಹಿಡಿಯುವವ, ಬಡಪೆಟ್ಟಿಗೆ ಬಗ್ಗದಿರು
ಜೀವ ಎಳೆ	ಮನಸ್ಸನ್ನು ಸೆಳೆ
ಜೀವಕ್ಕೆ ಎರವಾಗು	ಜೀವಕ್ಕೆ ಅಪಾಯ ತಗುಲು
ಜೀವಕ್ಕೆ ಬರು	ಅಪಾಯವುಂಟಾಗು
ಜೀವಗಳ್ಳ	ಹೇಡಿ, ಪುಕ್ಕಲ
ಜೀವ ಜಾಲಾಡು	ಅತಿಯಾಗಿ ದೂಷಿಸು
ಜೀವತುಂಬು	ಚೈತನ್ಯ ನೀಡು, ಶಕ್ತಿಕೊಡು
ಜೀವ ತೆಗೆ	ಹಿಂಸಿಸು, ಪೀಡಿಸು, ತೊಂದರೆ ಕೊಡು
ಜೀವ ತೇಯು	ಶ್ರಮಪಡು, ಬಹಳ ಕಷ್ಟಪಡು
ಜೀವದಾನ ಮಾಡು	ಮರುಜೀವ ನೀಡು, ಬದುಕಿಸು
ಜೀವನಾಡಿ	ಮುಖ್ಯ ಆಧಾರ
ಜೀವ ಬರು	ಧೈರ್ಯವುಂಟಾಗು
ಜೀವ ಬಿಡು	ತುಂಬ ಆಸೆ ಪಡು
ಜೀವ ಸವೆಸು	ಬಹಳ ಶ್ರಮಪಡು, ತುಂಬಾ ಕಷ್ಟಪಡು
ಜೀವ ಹಿಂಡು	ಬಹಳ ತೊಂದರೆ ಕೊಡು
ಜೀವ ಹಿಡಿ	ಸಹನೆಯಿಂದ ಇರು, ತಾಳ್ಮೆಯಿಂದ ಇರು
ಜುಟ್ಟು ಕೈಗೆ ಸಿಗು	ಹಿಡಿತಕ್ಕೆ ಬರು, ಅಧೀನವಾಗು
ಜುಟ್ಟು ಕೈಯ್ಯಲ್ಲಿರು	ಹಿಡಿತದಲ್ಲಿರು, ಅಂಕೆಯಲ್ಲಿ ಇರು
ಜುಟ್ಟು ಹಾರಿಸು	ಅಹಂಕಾರ ಮುರಿ, ತೇಜೋವಧೆ ಮಾಡು
ಜೇಬಿಗೆ ಹಾಕು	ಲಂಚ ನೀಡು
ಜೋತು ಬೀಳು	ಅವಲಂಬಿಸು, ಬೇರೆಯವರನ್ನು ಆಧರಿಸು
ಜೋಬಿಗೆ ಹಾಕಿಕೊಳ್ಳು	ವಶಪಡಿಸಿಕೊಳ್ಳು. ಒಳಗೆ ಹಾಕಿಕೊಳ್ಳುವುದು
ಜೋಲುಮುಖ ಹಾಕು	ಮುಖ ಇಳಿಬಿಡು, ನಿರುತ್ಸಾಹಿತನಾಗು
ಜೋಲು ಮೋರೆ ಹಾಕು	ನಿರುತ್ಸಾಹ ಹೊಂದು
ಜೋಳದ ಪಾಳಿ	ಅನ್ನದ ಋಣ
ಝಂಡಾ ಊರು	ಸ್ಥಿರವಾಗಿ ನಿಲ್ಲು
ಝಂಡಾ ಹೊಡೆ	ನೆಲೆನಿಲ್ಲು
ಟಬರು ನಡೆಸು	ಅಧಿಕಾರ ಚಲಾಯಿಸು, ದರ್ಪವನ್ನು ತೋರಿಸು
ಟಮಕಿ ಸಾರು	ಎಲ್ಲರಿಗೂ ತಿಳಿಯ ಪಡಿಸು, ಪ್ರಚಾರ ಮಾಡು
ಟಿಕೇಟು ಕೊಡು	ಒತ್ತಾಯಪೂರ್ವಕವಾಗಿ ಹೊರಡಿಸು
ಟೂ ಬಿಡು	ಸ್ನೇಹ ಬಿಡು, ಮಾತನಾಡದಿರು
ಟೊಂಕ ಕಟ್ಟಿ ನಿಲ್ಲು	ಸಿದ್ಧನಾಗು
ಟೊಪ್ಪಿಗೆ ಹಾರಿಸು	ಅಪಮಾನಗೊಳಿಸು
ಟೋಪಿ ಬೀಳು	ಮೋಸಹೋಗು
ಟೋಪಿ ಹಾಕು	ಮೋಸ ಮಾಡು
ಟ್ಯೂಬ್‌ ಲೈಟ್ ತಲೆಯವನು	ನಿಧಾನವಾಗಿ ತಿಳಿದುಕೊಳ್ಳುವವ
ಠಿಕಾಣಿ ಹಾಕು	ನೆಲೆ ನಿಲ್ಲು ತಂಗು
ಠೇವಣಿ ಕಳೆದುಕೊಳ್ಳು	ನಾಶವಾಗು, ಬೆಲೆ ಕಳೆದುಕೊಳ್ಳು
ಠೋಕರ ಹಾಕು	ಮೋಸ ಮಾಡು
ಡಂಗುರ ಸಾರು	ಬಹಿರಂಗ ಪಡಿಸು
ಡಂಗುರ ಹೊಡೆ	ಎಲ್ಲರಿಗೂ ತಿಳಿಯುವಂತೆ ಮಾಡು
ಡುಂಕಿ ಹೊಡೆ	ಪರೀಕ್ಷೆಯಲ್ಲಿ ಅನುತ್ತೀರ್ಣನಾಗು
ಡೊಗರು ಬೀಳು	ನಂಬಿಕೆ ಕೆಡು
ಡೊಗ್ಗಾಲು ಹಾಕು	ಬಹಳ ಶ್ರಮಪಡು
ಡೋಂಗಿ ಬಿಡು	ಸುಳ್ಳು ಹೇಳು
ಢಾಣಾ ಡಂಗುರ	ಎಲ್ಲರಿಗೂ ವಿಷಯ ತಿಳಿಸು, ಬಹಿರಂಗ ಪಡಿಸು
ಧೋಂಗಿ ಮಾಡು	ನಟಿಸು
ತಂದು ಹಾಕುವುದು	ಚಾಡಿ ಹೇಳಿ ಜಗಳ ತಂದಿಕ್ಕುವುದು
ತಂಬಿಗೆ ಕೈಗೆ ಬರು	ಬಡತನ ಬರು, ಶ್ರೀಮಂತಿಕೆ ಹೊರಟುಹೋಗುವುದು
ತಂಬುಲ ತಿನ್ನು	ಎಂಜಲು ತಿನ್ನು
ತಕರಾರು ತೆಗೆ	ಆಕ್ಷೇಪಿಸು, ವಿರೋಧಿಸು
ತಗಾದಿ ಹಚ್ಚು	ಒತ್ತಾಯ ಮಾಡು
ತಗುಲಿಸು	ಚುರುಕು ಮುಟ್ಟಿಸು
ತಣ್ಣಗಾಗು	ತೆಪ್ಪಗಾಗು, ಸಾಯು
ತಣ್ಣಗಿರು	ಸುಖವಾಗಿರು
ತಣ್ಣೀರೆರೆಚು	ಉತ್ಸಾಹಕ್ಕೆ ಕುಂದು ಬರಿಸು
ತಪಸ್ಸು ಮಾಡು	ಬಹಳ ಕಷ್ಟಪಡು
ತರಾಟೆಗೆ ತೆಗೆದುಕೊಳ್ಳು	ಬಹಳಷ್ಟು ಆಕ್ಷೇಪಿಸು
ತಲೆ ಅಪ್ಪಳಿಸು	ಆಕ್ರೋಶ ತೋರಿಸು
ತಲೆ ಓಡಿಸು	ಜಾಣತನ ಬಳಸು, ಬುದ್ದಿ ಉಪಯೋಗಿಸು
ತಲೆ ಕಾಯಿ	ಮರ್ಯಾದೆ ಉಳಿಸು
ತಲೆಕೆಡಿಸು	ಅಭಿಪ್ರಾಯಗಳು ಬದಲಾಗುವಂತೆ ಮಾಡು
ತಲೆಕೆಡು	ಬುದ್ಧಿಭ್ರಮಣೆಯಾಗು
ತಲೆ ಕೆಳಗಾಗು	ವ್ಯತ್ಯಾಸವಾಗು, ಅಸ್ತವ್ಯಸ್ತವಾಗು
ತಲೆಗೆ ಕಟ್ಟು	ಜವಾಬ್ದಾರಿಯನ್ನು ಬಲವಂತವಾಗಿ ಹೊರಿಸು
ತಲೆಗೆ ಬರು	ತೊಂದರೆಯಾಗು
ತಲೆಗೆ ಹಚ್ಚಿಕೊಳ್ಳು	ಚಿಂತಿಸು, ಬಹಳ ಯೋಚಿಸು
ತಲೆಗೆ ಹತ್ತು	ತಿಳಿವಳಿಕೆಯುಂಟಾಗು
ತಲೆಗೆ ಹಾಕಿಕೊಳ್ಳು	ಗಮನಕೊಡು
ತಲೆಗೇರಿಸು	ಹೆಚ್ಚು ಸಲಿಗೆ ಕೊಡು
ತಲೆಗೇರು	ಹೆಚ್ಚಾಗು, ಮಿತಿಮೀರು
ತಲೆಚಿಟ್ಟು ಹಿಡಿ	ಅಸಹನೆ, ಜುಗುಪ್ಪೆಯಾಗು
ತಲೆ ತಗ್ಗಿಸು	ಸಮ್ಮತಿಸು, ಒಪ್ಪು
ತಲೆ ತಣ್ಣಗಾಗು	ಸಮಾಧಾನವಾಗು
ತಲೆತಿಕ್ಕು	ದುರ್ಬೋಧನೆ ಮಾಡು
ತಲೆ ತಿನ್ನು	ತೊಂದರೆ ಕೊಡು, ಬೇಸರ ಬರುವಂತೆ ಮಾಡು
ತಲೆ ತಿರುಕ	ತನಗೆ ಇಷ್ಟ ಬಂದಂತೆ ಕೆಲಸ ಮಾಡುವವ
ತಲೆ ತಿರುಗು	ಅಹಂಕಾರ ಬರು, ದರ್ಪಿಸು
ತಲೆದಂಡ	ಶಿಕ್ಷೆ ಮರಣ ದಂಡನೆ
ತಲೆದೂಗು	ಮೆಚ್ಚು ಮೆಚ್ಚುಗೆ ತೋರಿಸು
ತಲೆ ನಿಲ್ಲದಿರು	ಅಹಂಕಾರ, ಗರ್ವ
ತಲೆ ಬಿಸಿಯಾಗು	ಹೆಚ್ಚು ಆಯಾಸವಾಗು, ಬಹಳ ಶ್ರಮವಾಗು
ತಲೆ ಬೋಳಿಸು	ನಷ್ಟವನ್ನುಂಟು ಮಾಡು
ತಲೆ ಭಾರವಾಗು	ಚಿಂತೆಯಿಂದ ತಲೆನೋವು ಬರುವುದು
ತಲೆ ಮರೆಸಿಕೊಳ್ಳು	ಕಾಣದಂತೆ ಇರು, ಅಡಗಿಕೊಳ್ಳು
ತಲೆ ಮಾಸಿದವ	ಕೆಲಸಕ್ಕೆ ಬರದವ
ತಲೆ ಮೇಲೆ ಬರು	ಅಪವಾದ ಬರು
ತಲೆಯ ಮೇಲೆ ಕೂರು	ಒತ್ತಾಯಿಸು, ಅತಿ ಸಲಿಗೆ ತೋರಿಸು
ತಲೆಯ ಮೇಲೆ ಕೈಯಿಡು	ಮೋಸ ಮಾಡು
ತಲೆಯ ಮೇಲೆ ಬೀಳು	ಜವಾಬ್ದಾರಿ ಹೊರುವಂತಾಗು
ತಲೆಯ ಮೇಲೆ ಮೆಣಸು ಅರೆ	ಅತಿಯಾಗಿ ತೊಂದರೆ ನೀಡು
ತಲೆಯ ಮೇಲೆ ಹೊತ್ತುಕೊಳ್ಳು	ಹೆಚ್ಚು ಜವಾಬ್ದಾರಿಯನ್ನು ಹೊರು
ತಲೆ ಅಲ್ಲಾಡಿಸು	ಸಮ್ಮತಿಸು
ತಲೆಯಲ್ಲೇ ಮೆರೆ	ಅಹಂಕಾರದಿಂದ ವರ್ತಿಸು
ತಲೆ ಉಳಿಸಿಕೋ	ಅಪಾಯದಿಂದ ಪಾರಾಗು
ತಲೆಯೆತ್ತಿತಿರುಗು	ಮರ್ಯಾದೆಯಿಂದ ಜೀವನ ನಡೆಸು
ತಲೆಯೆತ್ತಿ ನಿಲ್ಲು	ಸ್ಥಾಪನೆಯಾಗು, ಆತ್ಮವಿಶ್ವಾಸ ಬರು, ಗೌರವದಿಂದಿರು
ತಲೆಯೆಲ್ಲಾ ಮಾತನಾಡು	ವಿಪರೀತ ಮಾತನಾಡು, ಅನವಶ್ಯಕವಾಗಿ ಮಾತನಾಡು
ತಲೆಯೊಡ್ಡು	ಗುರಿಯಾಗು, ಜವಾಬ್ದಾರಿ ಹೊರು
ತಲೆಸವರು	ಕನಿಕರ ತೋರಿಸು, ಸಮಾಧಾನ ಮಾಡು
ತಲೆಸುತ್ತು	ಅಹಂಕಾರ ತೋರು
ತಲೆ ಹರಟೆ	ಅತಿಯಾಗಿ ಮಾತನಾಡುವವ, ಅಧಿಕಪ್ರಸಂಗಿ
ತಲೆಹಾಕು	ನಡುವೆ ಪ್ರವೇಶಿಸು
ತಲೆ ಹಿಡಿ	ವ್ಯಭಿಚಾರಕ್ಕೆ ಪ್ರೇರೇಪಣೆ ನೀಡು
ತಲೆಹೋಕ	ವಂಚಕ, ಧೂರ್ತ
ತಲೆಹೋಗು	ಪ್ರಾಣಹೋಗು, ತೊಂದರೆಯುಂಟಾಗು
ತಳಕೀಳು	ಸ್ಥಾನಪಲ್ಲಟವಾಗು, ದೂರವಾಗು
ತಳಕು ಹಾಕು	ಸಂಬಂಧಕಲ್ಪಿಸು
ತಳ ಮುಟ್ಟಿಸು	ಎದೆಗುಂದುವಂತೆ ಮಾಡು, ಕುಗ್ಗಿಸು
ತಳವೂರು	ಕುಳಿತುಕೋ, ಅಲ್ಲಿಯೇ ಇರು
ತಳ ಹತ್ತು	ಮೂಲವನ್ನು ತಿಳಿ, ನೆಲೆಯನ್ನು ತಿಳಿ
ತಳ್ಳಿಬಿಡು	ಕಡೆಗಣಿಸು, ನಿರಾಕರಿಸು
ತಳ್ಳಿಹಾಕು	ನಿರಾಕರಿಸು, ನಿರ್ಲಕ್ಷಿಸು
ತಾಂಡವವಾಡು	ಹರಡು, ವ್ಯಾಪಿಸು, ವ್ಯಕ್ತವಾಗು
ತಾಜಾ ಮಾಡು	ಪುಸಲಾಯಿಸು, ಗಿಲೀಟು ಮಾಡು
ತಾತನ ಕಾಲದವ	ಕಂದಾಚಾರಿ, ಹಳೆಯ ಕಾಲದವ
ತಾರಮ್ಮಯ್ಯ ಹಾಡು	ಪರೋಕ್ಷವಾಗಿ ಇಲ್ಲವೆಂದು ಹೇಳು
ತಾರಾಬಲ	ಅದೃಷ್ಟ ಭಾಗ್ಯ
ತಾಳತಂತಿ	ಹೊಂದಾಣಿಕೆ
ತಾಳ ಹಾಕು	ಹೇಳಿದ್ದಕ್ಕೆಲ್ಲ ಹೂಂ ಗುಟ್ಟು
ತಿಂಗಳು ತುಂಬು	ಗರ್ಭಕಟ್ಟು ಹೆರಿಗೆಯ ವೇಳೆ ಸನ್ನಿಹಿತವಾಗು
ತಿಂದು ತೇಗು	ಬೇರೆಯವರ ಆಸ್ತಿಯನ್ನು ಎತ್ತಿಹಾಕು
ತಿಂದು ಹಾಕು	ನಾಶಮಾಡು, ಹಾಳುಮಾಡು
ತಿಥಿ ಮಾಡು	ಹಿಂಸೆ ಕೊಡು, ಕಷ್ಟಕ್ಕೆ ಒಳಪಡಿಸು
ತಿದಿಯೂದು	ಪ್ರೋತ್ಸಾಹಿಸು, ಒತ್ತಾಯಿಸು
ತಿಪ್ಪರಲಾಗ ಹಾಕು	ಕಷ್ಟಪಡು / ತಿರುಪು ಲಾಗ ಹಾಕು
ತಿಪ್ಪೆ ಕೆದರು	ಹಳೆಯ ವಿಷಯಗಳನ್ನು ಹೊರಗೆ ಹಾಕು
ತಿಪ್ಪೆ ಸಾರಿಸು	ದೋಷಗಳನ್ನು ಮುಚ್ಚಿಟ್ಟು ತೋರಿಸು
ತಿಪ್ಪೆ ಪಾಲಾಗು	ಬಡತನ ಬರು, ದರಿದ್ರನಾಗು
ತಿರುಕನ ಕನಸು	ಈಡೇರದ ಆಸೆ, ಬಯಕೆ
ತಿರುಗಾಲು	ಬಹಳಷ್ಟು ಅಲೆಯುವವ
ತಿರುಗಿ ಬೀಳು	ಎದುರು ಹೇಳು, ಪ್ರತಿಭಟಿಸು
ತಿರುಪತಿ ಆಗು	ನಷ್ಟವಾಗು, ಎಲ್ಲವನ್ನೂ ಕಳೆದುಕೊಳ್ಳು
ತಿರುಪತಿ ಕ್ಷೌರ	ಅರ್ಧಂಬರ್ಧ ಮಾಡುವ ಕೆಲಸ
ತಿರುಪೆ ಎತ್ತು	ಭಿಕ್ಷೆ ಬೇಡು
ತಿರುಮಂತ್ರ	ಹೇಳಿದವನಿಗೆ ಕಲಿತದ್ದನ್ನು ಮರಳಿ ಕಲಿಸು
ತಿಲಕಪ್ರಾಯ	ಭೂಷಣವಾದುದು, ಉತ್ತಮವಾದುದು
ತಿಲಾಂಜಲಿ ನೀಡು	ಮರೆತು ಬಿಡು
ತಿಲೋದಕ ಬಿಡು	ಮರೆತು ಬಿಡು, ಬಿಟ್ಟು ಬಿಡು
ತೀರಿಕೊಳ್ಳು	ಮರಣ ಹೊಂದು
ತುಂಬಿದ ಕೊಡ	ಜಂಬವಿಲ್ಲದಿರುವವ
ತುಂಬಿದ ಸಂಸಾರ	ಹೆಂಡತಿ ಮಕ್ಕಳಿಂದ ಕೂಡಿದ ಸಂಸಾರ
ತಂಬು ಹೃದಯ	ಒಳ್ಳೆಯ ಮನಸ್ಸಿನಿಂದ
ತುಟಿ ಎರಡು ಮಾಡು	ಬಾಯಿ ಬಿಡು
ತುಟಿ ಕಚ್ಚಿಕೊಳ್ಳು	ಮಾತಿನ ತಪ್ಪು ಅರಿವಾಗಿ ತಕ್ಷಣ ನಿಲ್ಲಿಸು
ತುಟಿಗಳ ಮೇಲೆ ಬೆರಳಿಡು	ಸುಮ್ಮನಿರಲು ಸೂಚಿಸು
ತುಟಿ ಚಪ್ಪರಿಸು	ಆಸೆ ಬರು, ತಿನ್ನಲು ಬಯಕೆಯಾಗು
ತುಟಿ ಪಿಟಕ್ಕೆನ್ನದಿರು	ಮಾತನಾಡದಿರುವುದು
ತುಟಿ ಬಿಗಿಹಿಡಿ	ಹೆಚ್ಚಿಗೆ ಮಾತನಾಡದಿರುವುದು
ತುಟಿ ಮೀರು	ಮಿತಿ ಮೀರು
ತುಟಿಯಲ್ಲೇ ನಗು	ಕುಹಕವಾಗಿ ನಗು
ತುಟಿ ಹೊಲಿದುಕೊಳ್ಳು	ಮಾತನಾಡದೇ ಇರು
ತುತ್ತಿನ ಚೀಲ	ಹೊಟ್ಟೆ ಹಸಿವು
ತುತ್ತೂರಿ ಊದು	ಸ್ವ ಪ್ರಶಂಸೆ ಮಾಡಿಕೊಳ್ಳು, ತನ್ನ ಬಗ್ಗೆ ತಾನೇ ಪ್ರಚಾರ ಕೊಟ್ಟುಕೊಳ್ಳುವುದು
ತುದಿಗಾಲ ಮೇಲೆ ನಿಲ್ಲು	ಸಿದ್ಧವಾಗು
ತೂಕ ಕೆಡಿಸು	ಆರೋಗ್ಯ ಹಾಳುಮಾಡು
ತೂಕವಿರು	ಅಧಿಕಾರವಿರು, ಗೌರವವಿರು
ತೂಗಿ ನೋಡು	ಯೋಗ್ಯತೆಯನ್ನು ಪರೀಕ್ಷಿಸು
ತೂತು ಮುಚ್ಚು	ದೋಷಗಳನ್ನು ಮುಚ್ಚಿಡು
ತೃಣಪ್ರಾಯ	ಬಹಳ ಅಲ್ಪವಾದುದು, ಸ್ವಲ್ಪ
ತೆರೆ ಎಳೆ	ಮುಗಿಸು, ತೀರ್ಮಾನಿಸು, ಕೊನೆಗೊಳಿಸು
ತೆರೆದ ಪುಸ್ತಕ	ಮುಚ್ಚು ಮರೆ ಏನೂ ಇಲ್ಲದಿರುವುದು
ತೆರೆಯ ಮರೆ	ಮುಚ್ಚು ಮರೆ, ಗುಟ್ಟು ರಹಸ್ಯ
ತೇಪೆ ಕೆಲಸ	ಅರ್ಧಂಬರ್ಧ ಮಾಡಿದ ಕೆಲಸ
ತೇಪೆ ಹಾಕು	ದುರಸ್ಥಿ ಮಾಡು
ತೇಲುಗಣ್ಣು ಮೇಲುಗಣ್ಣು ಬಿಡು	ಬಹಳ ಸುಸ್ತಾಗು, ಆಯಾಸವಾಗು, ಮರಣಕ್ಕೆ ಹತ್ತಿರವಾಗು
ತೊಟ್ಟಿಲಿಗೆ ತಾಳಿ ಕಟ್ಟಿಸು	ಬಾಲ್ಯದಲ್ಲೇ ವಿವಾಹ ಮಾಡು
ತೊಡೆ ತಟ್ಟಿ ನಿಲ್ಲು	ಜಗಳಕ್ಕೆ ನಿಲ್ಲು
ತೊಳಸಂಬಟ್ಟೆ	ಸರಿಯಿಲ್ಲದಿರುವುದು, ಹೊಂದಾಣಿಕೆಯಿಲ್ಲದಿರುವುದು
ತೊಳೆದ ಕೆಂಡ	ಅತಿಯಾದ ಕಪ್ಪು ಮೈ
ತೊಳೆದ ಮುತುತಿ	ಶುಭ್ರವಾದುದು
ತೊಳೆದುಕೊಳ್ಳು	ಹಾಳು ಮಾಡಿಕೊಳ್ಳುವುದು
ತೋಡಿಕೊಳ್ಳು	ಮನಸ್ಸಿನಲ್ಲಿರುವುದನ್ನು ಹೇಳಿಕೊಳ್ಳುವುದು
ತೋಳು ಮುರಿ	ಅಸಹಾಯಕನಾಗು
ತೋಳೇರಿಸು	ಯುದ್ಧಕ್ಕೆ ಸಿದ್ಧನಾಗು, ಜಗಳಕ್ಕೆ ಸಿದ್ಧನಾಗು
ತೌಡು ಕುಟ್ಟು	ವ್ಯರ್ಥವಾಗಿ ಮಾತನಾಡು, ಮೂರ್ಖತನ
ತ್ರಿಶಂಕು ಸ್ವರ್ಗ	ಅತ್ತಲೂ ಇಲ್ಲ: ಇತ್ತಲೂ ಇಲ್ಲ ಎಂಬಂಥಹ ಸ್ಥಿತಿ
ದಂಗುಬಡಿ	ಆಶ್ಚರ್ಯಪಡು
ದಂಡಪಿಂಡ	ವ್ಯರ್ಥವಾಗಿ ತಿಂದು ಜೀವಿಸುವವ
ದಂಡಯಾತ್ರೆ	ಪದೇಪದೇ ಅನುತ್ತೀರ್ಣನಾಗುವುದು
ದಂಡೆಗೆ ಹಚ್ಚು	ಸರಿದಾರಿಗೆ ತರು
ದಂಡೆ ಸೇರು	ಕೊನೆಗಾಣು, ಗುರಿಮುಟ್ಟು
ದಗಾ ಹಾಕು	ವಂಚಿಸು, ಮೋಸಮಾಡು
ದಡ ಕಾಣು	ಗುರಿ ಮುಟ್ಟು ಕೊನೆಗಾಣು
ದಡ್ಡ ಶಿಖಾಮಣಿ	ಮೂರ್ಖ, ತುಂಬ ದಡ್ಡ
ದಪ್ಪ ಚರ್ಮ	ಯಾವುದಕ್ಕೂ ಬಗ್ಗದವ
ದಮ್ಮಯ್ಯ ಗುಡ್ಡೆ ಹಾಕು	ಗೋಗರೆ, ಬೇಡು, ಯಾಚಿಸು
ದಮ್ಮು ಕಳೆದುಕೊಳ್ಳು	ಶಕ್ತಿಗುಂದು
ದರ್ಬಾರು ನಡೆಸು	ಅಧಿಕಾರ ನಡೆಸು, ಜಬರದಸ್ತು ಮಾಡು
ದಾರಿ ಕಾಣು	ಉಪಾಯ ಹೊಳೆ
ದಾರಿ ಕಾಯು	ಯಾರದಾದರೂ ಬರವನ್ನು ಎದಿರು ನೋಡುವುದು
ದಾರಿಗೆ ತರು	ಒಳ್ಳೆಯ ನಡತೆಯನ್ನು ಕಲಿಸುವುದು
ದಾರಿಗೆ ಬರು	ಸರಿಯಾದ ದಾರಿಯನ್ನು ಕಲಿಯುವುದು
ದಾರಿಗೆ ಹಚ್ಚು	ಸರಿಯಾದ ಮಾರ್ಗದಲ್ಲಿ ನಡೆಸು
ದಾರಿ ತಪ್ಪಿಸು	ಕೆಟ್ಟದಾರಿಗೆ ಕರೆದೊಯ್ಯು
ದಾರಿ ತಪ್ಪು	ಕೆಟ್ಟ ದಾರಿಯಲ್ಲಿ ನಡೆ
ದಾರಿ ತೋರಿಸು	ಜೀವನ ನಡೆಸಲು ಸರಿಯಾದ ಮಾರ್ಗ ತೋರಿಸು
ದಿಕ್ಕಾಗು	ಆಶ್ರಯವಾಗು, ನೆರವಾಗು
ದಿಕ್ಕು ತಪ್ಪಿಸು	ತಪ್ಪುದಾರಿಗೆ ಕರೆದೊಯ್ಯು
ದಿಕ್ಕುತೋಚದಿರು	ದಾರಿಕಾಣದಂತಾಗು
ದಿನ ಎಣಿಸು	ಸಾವನ್ನು ಎದಿರು ನೋಡುವುದು, ಕೊನೆಗಾಲ ಹತ್ತಿರ ಬರು
ದಿನ ತಳ್ಳು	ವೇಳೆಯನ್ನು ಕಳೆಯುವುದು
ದಿನ ನೂಕು	ಕಷ್ಟಪಟ್ಟು ಜೀವನ ಸಾಗಿಸು
ದಿನ ಸಾಗು	ಬದುಕು ಹೇಗೋ ನಡೆಯುವುದು
ದಿವಾಳಿ ಏಳು	ಎಲ್ಲವನ್ನು ಕಳೆದುಕೊಳ್ಳುವುದು, ಇರುವುದನ್ನು ನಷ್ಟ ಮಾಡಿಕೊಳ್ಳುವುದು
ದೀಪ ಬೆಳೆಸು	ಅಭಿವೃದ್ಧಿಗೊಳಿಸು, ವಂಶವನ್ನು ಬೆಳೆಸು
ದೂರವಿಡು	ಅತಿಯಾದ ಸಲಿಗೆ ಕೊಡದಿರುವುದು
ದೂರ್ವಾಸ	ಶೀಘ್ರದಲ್ಲಿ ಕೋಪವುಂಟಾಗುವವ
ದೃಷ್ಟಿ ತಗುಲು	ಕೆಟ್ಟ ಕಣ್ಣು ತಗುಲು
ದೃಷ್ಟಿ ತಾಗು	ಕೆಟ್ಟವರ ಕಣ್ಣು ಬೀಳುವುದು
ದೃಷ್ಟಿ ತೆಗೆ	ದೃಷ್ಟಿಯಿಂದಾದ ದೋಷವನ್ನು ನಿವಾರಿಸುವುದು
ದೃಷ್ಟಿ ನಿವಾಳಿಸು	ದೃಷ್ಟಿಯಿಂದಾದ ದೋಷವನ್ನು ನಿವಾರಿಸುವುದು
ದೃಷ್ಟಿ ಬೀಳು	ಕೆಟ್ಟ ಕಣ್ಣು ತಗುಲುವುದು
ದೃಷ್ಟಿ ಹರಿಸು	ಗಮನಿಸು, ನೋಡು
ದೆವ್ವ ಬಿಡಿಸು	ಚೆನ್ನಾಗಿ ಬಡಿ, ಹೊಡೆ, ಥಳಿಸು
ದೇಶಾವರದ ನಗು	ಮನಸ್ಸಿಲ್ಲದೆ ಯಾಂತ್ರಿಕವಾಗಿ ನಗುವುದು
ದೇಶಾವರ ಮಾಡು	ಭಿಕ್ಷೆ ಎತ್ತು
ದೊಂಬಿ ಏಳು	ದಂಗೆ ಏಳು, ಎದುರಿಸು
ದೊಡ್ಡವಳಾಗು	ಮೈನೆರೆ, ಪುಷ್ಪವತಿಯಾಗು
ದೊಣ್ಣೆ ನ್ಯಾಯ	ಬಲಿಷ್ಠರು ಮಾಡುವ ನೀತಿ, ಹೊಡೆತದ ಬೆದರಿಕೆ
ದೌಡು ಕೀಳು	ಓಡಿಹೋಗು, ಪಲಾಯನ ಮಾಡು
ದೌಲತ್ತು ಮಾಡು	ಅಧಿಕಾರ ಚಲಾಯಿಸು
ದ್ರಾವಿಡ ಪ್ರಾಣಾಯಾಮ	ಸುತ್ತಿಬಳಸಿ ಮಾಡುವ ಸಾಧನೆ, ಬಳಸು ದಾರಿ
ಧರಣಿ ಹೂಡು	ಮುಷ್ಕರವನ್ನು ಮಾಡು
ಧರ್ಮದ ಬಡ್ಡಿ	ನ್ಯಾಯವಾದ ಬಡ್ಡಿ
ಧರ್ಮರಾಯ	ಸಾತ್ವಿಕ ವ್ಯಕ್ತಿ, ಮೋಸ ವಂಚನೆ ಅರಿಯದವನು
ಧೂಪ ಹಾಕು	ಪೂಜೆ ಮಾಡು, ಗೌರವಿಸು
ಧೂಮಕೇತು	ಕೇಡು ಬರುವ ಸಂಕೇತ, ಅಶುಭ ಸಂಕೇತ
ಧೂಳೀಪಟ ಮಾಡು	ನಾಶ ಮಾಡು, ಹಾಳು ಮಾಡು
ಧೂಳು ಝಾಡಿಸು	ವಿಚಾರಣೆ ನಡೆಸು, ತರಾಟೆಗೆ ತೆಗೆದುಕೊಳ್ಳು
ಧ್ವಜ ಊರು	ಠಿಕಾಣಿ ಹಾಕು, ಇದ್ದಲ್ಲಿಯೇ ಇರು
ನಂಜು ಕಾರು	ಹೊಟ್ಟೆಕಿಚ್ಚು ಪಡು, ಕರುಬು
ನಂಜು ನುಡಿ	ಹೊಟ್ಟೆಕಿಚ್ಚಿನ ಮಾತು, ಮಾತ್ಸರ್ಯ
ನಕ್ಷತ್ರಿಕ	ತೊಂದರೆ ಕೊಡುವವ, ಪೀಡಿಸುವವ
ನಗಾರಿ ಬಾರಿಸು	ಜೋರಾಗಿ ಕೂಗಿಕೊಳ್ಳು
ನಡುಕಟ್ಟು	ಸಿದ್ಧನಾಗಿರು, ಅಣಿಯಾಗು
ನಡು ಬಗ್ಗಿಸು	ಶ್ರಮಪಟ್ಟು ಕೆಲಸ ಮಾಡು
ನರಪಿಳ್ಳೆ	ಸಾಧಾರಣ ಮನುಷ್ಯ
ನರಿ	ಮೋಸಗಾರ, ಕುಟಿಲ ಸ್ವಭಾವದವ
ನರಿ ಕೊಂಬು	ಅಸಂಭವವಾದ ವಸ್ತು, ಕಾಲ್ಪನಿಕ ವಸ್ತು
ನರಿಯ ಬುದ್ಧಿ	ಮೋಸಗಾರಿಕೆ, ತಂತ್ರಗಾರಿಕೆ
ನಸುಗುನ್ನಿಕಾಯಿ	ಕೀಟಲೆ ಸ್ವಭಾವದವ
ನಾಂದಿ ಹಾಡು	ಆರಂಭಿಸು, ಪ್ರಾರಂಭಮಾಡು, ಮೊದಲು ಮಾಡು
ನಾಟಕ ಆಡು	ಏನೂ ಗೊತ್ತಿಲ್ಲದಂತೆ ಇರು
ನಾಮ ಹಾಕು	ಮೋಸ ಮಾಡು, ಅನ್ಯಾಯ ಮಾಡು
ನಾಯಿ ಕಿವಿ	ಚುರುಕಾದ ಕಿವಿ
ನಾಯಿಜನ್ಮ	ಕೆಟ್ಟ ಜನ್ಮ ನೀಚ ಕುಲ
ನಾಯಿ ಪಾಡು	ಹೀನಾಯ ಸ್ಥಿತಿ
ನಾಯಿ ಪಾಲಾಗು	ಹಾಳಾಗಿ ಹೋಗು, ನಷ್ಟವಾಗು
ನಾಯಿ ಬದುಕು	ಕೀಳು ಬದುಕು, ಹೇಯವಾದ ಜೀವನ
ನಾಯಿ ಬಾಲ	ತಿದ್ದಲಾರದ ಗುಣ, ಬದಲಾಯಿಸಲಾಗದ ಸ್ವಭಾವ
ನಾಯಿಬುದ್ಧಿ	ನೀಚತನ, ಅಲ್ಪತನ
ನಾಯಿ ಮೊಲೆಯ ಹಾಲು	ನಿಷ್ಟ್ರಯೋಜಕವಾದುದು
ನಾರದ	ಚಾಡಿಕೋರ, ಇಬ್ಬರ ನಡುವೆ ಜಗಳ ತಂದಿಕ್ಕಿ ಮೋಜು ನೋಡುವವ
ನಾಲಗೆ ಉದ್ದಬಿಡು	ಮಿತಿ ಮೀರಿ ಮಾತನಾಡು
ನಾಲಗೆ ಚಪ್ಪರಿಸು	ಆಸೆ ಪಡು, ಇಚ್ಛೆಪಡು
ನಾಲಗೆ ತಪ್ಪು	ಮಾತಿಗೆ ತಪ್ಪು
ನಾಲಗೆ ಬರು	ಮಾತನಾಡಲು ಮನಸ್ಸು ಮಾಡು
ನಾಲಗೆ ಬೀಳು	ಮಾತು ಬರದಂತಾಗು. ಮೂಗನಾಗು
ನಾಲಗೆಯ ತೀಟೆ	ಮಾತನಾಡಬೇಕೆಂಬ ಚಪಲ
ನಾಲಗೆಯಾಡಿಸು	ಮಾತನಾಡು
ನಾಲಗೆ ಸತ್ತುಹೋಗು	ಮಾತು ಬಾರದಿರು, ರುಚಿಕೆಡುವುದು
ನಾಲಗೆ ಹರಿತವಾಗು	ತೀಕ್ಷ್ಮವಾಗಿ ಮಾತನಾಡು
ನಾಲಗೆ ಹರಿಬಿಡು	ಮನಸ್ಸಿಗೆ ತೋಚಿದಂತೆ ಮಾತನಾಡು
ನಾಲಗೆ ಉದ್ದವಾಗು	ಹೆಚ್ಚಾಗಿ ಮಾತನಾಡು
ನಾಲಗೆ ಕಿತ್ತುಬರು	ದುಃಖ ಹೆಚ್ಚಾಗುವುದು
ನಾಲಗೆ ಸಡಿಲ ಬಿಡು	ತುಂಬಾ ಮಾತನಾಡು, ಹೆಚ್ಚು ಮಾತನಾಡು
ನಾಲಗೆ ಹೋಗು	ಮಾತನಾಡುವ ಶಕ್ತಿ ಹೋಗುವುದು
ನಾಲ್ಕು ಜನರಿಗೆ ಬೇಕಾಗು	ಜನಪ್ರಿಯನಾಗು
ನಿಕಾಲಿ ಮಾಡು	ಬಗೆಹರಿಸು, ಇತ್ಯರ್ಥಗೊಳಿಸು
ನಿಗಿತುಕೊಳ್ಳು	ಸತ್ತು ಹೋಗು, ಮರಣಿಸು
ನಿದ್ದೆ ತಿಳಿ	ಎಚ್ಚರವಾಗು, ಏಳು, ಎದ್ದೇಳು
ನಿದ್ದೆ ಹರಿ	ಎಚ್ಚರವಾಗು, ಎದ್ದೇಳು
ನಿವಾಳಿಸು	ದೃಷ್ಟಿ ತೆಗೆದು ಚೆಲ್ಲು ಕಡೆಗಣಿಸು
ನೀರಮೇಲಣ ಗುಳ್ಳೆ	ನಶ್ವರವಾದುದು, ಅಶಾಶ್ವತ
ನೀರಲ್ಲಿ ಹಾಕು	ವ್ಯರ್ಥಮಾಡು, ಹಾಳುಗೆಡಿಸು
ನೀರಲ್ಲಿ ಹೋಮ ಮಾಡು	ವ್ಯರ್ಥಗೊಳಿಸು
ನೀರು ಕುಡಿಸು	ಕಷ್ಟದಲ್ಲಿ ಸಿಕ್ಕಿಸು
ನೀರು ಪಾಲಾಗು	ಹಾಳಾಗು, ದಿವಾಳಿಯಾಗು, ನಾಶವಾಗು
ನೀರು ಪಾಲು ಮಾಡು	ಹಾಳು ಮಾಡು, ನಾಶ ಮಾಡು
ನೀರೆರೆಚು	ಉತ್ಸಾಹ ಕುಂದಿಸು, ಕಡಿಮೆಗೊಳಿಸು
ನೀಲಿ ಹಾಕು	ಮೋಸ ಮಾಡು, ವಂಚಿಸು
ನುಂಗಲಾರದ ತುತ್ತು	ಅರ್ಥಮಾಡಿಕೊಳ್ಳಲು ಕಷ್ಟವಾದುದು, ನಿಭಾಯಿಸಲು ಸಾಧ್ಯವಾಗದುದು
ನುಂಗುವಂತೆ ನೋಡು	ದುರುಗುಟ್ಟಿಕೊಂಡು ನೋಡು, ಕೋಪದಿಂದ ನೋಡು
ನುಗ್ಗಿ ನುಸಿಮಾಡು	ನಾಶಮಾಡು, ಧ್ವಂಸಮಾಡು
ನುಗ್ಗ ನುಸಿಯಾಗು	ಹಾಳಾಗು, ನಾಶವಾಗು
ನುರಿತ ಕೈ	ಅನುಭವ ಹೊಂದಿದವ, ಪ್ರವೀಣ
ನೆಗೆದು ಬೀಳು	ನಾಶವಾಗು, ಸಾಯು, ಮರಣಹೊಂದು
ನೆತ್ತರು ಕುದಿ	ಬಹಳ ಕೋಪ ಬರು
ನೆತ್ತರು ಬಸಿ	ಹೆಚ್ಚು ಶ್ರಮಪಡು
ನೆತ್ತಿಗೇರು	ಗರ್ವಬರು, ಅಹಂಕಾರ ಬರು
ನೆತ್ತಿಯ ಮೇಲೆ ಕಣ್ಣು ಬರು	ಅಹಂಕಾರ ಬರು, ಕೊಬ್ಬು ಬರು
ನೆನೆಗುದಿಗೆ ಬೀಳು	ನಿರ್ಧಾರಿತವಿಲ್ಲದಿರು, ಅನಿಶ್ಚಿತ
ನೆರಳು ಕುಗ್ಗು	ಆಯಸ್ಸು ಕ್ಷೀಣಿಸು, ಭಾಗ್ಯ ಕಡಿಮೆಯಾಗು
ನೆರಳು ಕೊಡು	ಆಸರೆ ನೀಡು
ನೆಲಕಚ್ಚು	ನಾಶವಾಗು, ಸೋತು ಹೋಗು, ಹತಾಶನಾಗು
ನೆಲ ನೋಡು	ನಾಚಿಕೆ ಪಡು, ಸಂಕೋಚ ಪಡು
ನೆಲಸಮ ಮಾಡು	ನಾಶಗೊಳಿಸು, ಹಾಳುಗೆಡಹು
ನೆಲ ಹಿಡಿ	ರೋಗದಿಂದ ಬಳಲು
ನೇಗಿಲು ಹಿಡಿ	ಬೇಸಾಯ ಮಾಡು, ವ್ಯವಸಾಯ ಮಾಡು
ನೊಗ ಇಳಿ	ಜವಾಬ್ದಾರಿ ಕಳೆ
ನೊಗಕ್ಕೆ ತಲೆ ಕೊಡು	ಭಾರ ವಹಿಸಿಕೊಳ್ಳು
ನೊಗ ಹೊರು	ಜವಾಬ್ದಾರಿ ಹೊರು, ಭಾರ ಹೊತ್ತುಕೊಳ್ಳು
ನೊಣ ಹೊಡೆ	ಕೆಲಸವಿಲ್ಲದೆ ಸುಮ್ಮನೆ ಕುಳಿತಿರು
ನೊಣೆದು ನುಂಗು	ಸಂಪೂರ್ಣವಾಗಿ ನಾಶವಾಗು
ನೊರೆಯಾರು	ತಣ್ಣಗಾಗು
ನ್ಯಾಯ ತೀರಿಸು	ವ್ಯಾಜ್ಯವನ್ನು ಇತ್ಯರ್ಥಗೊಳಿಸು
ಪಂಗನಾಮ ಹಾಕು	ಮೋಸ ಮಾಡು, ವಂಚಿಸು
ಪಂಚಪ್ರಾಣ	ಅತಿ ಪ್ರಿಯವಾದ ವಸ್ತು
ಪಂಚಾಂಗ ಬಿಚ್ಚು	ಕೆಲಸವಿಲ್ಲದ ಒಣ ಹರಟೆ ಹೊಡೆ
ಪಂಪು ಹೊಡೆ	ಪುಸಲಾಯಿಸು, ಪ್ರೋತ್ಸಾಹಿಸು
ಪಟ್ಟಕ್ಕೆ ಬರು	ವಯಸ್ಸಿಗೆ ಬರು, ಅಧಿಕಾರಕ್ಕ ಬರು
ಪಟ್ಟು ಹಿಡಿ	ಹಟ ಮಾಡು, ಮೊಂಡಾಟಿಕೆ ಮಾಡು
ಪದರಿಗೆ ಹಾಕಿಕೊಳ್ಳು	ತನ್ನದನ್ನಾಗಿ ಮಾಡಿಕೊಳ್ಳು
ಪದ ಹಾಡು	ಮುಕ್ತಾಯ ಮಾಡು, ಕೊನೆಗೊಳಿಸು
ಪದ ಹೇಳಿಸು	ಗೋಳುಹುಯ್ದುಕೊಳ್ಳು
ಪದಾರ್ಪಣ ಮಾಡು	ಅನುಸರಿಸು, ಸಾಗು
ಪರಟೆ ಹಿಡಿ	ಭಿಕ್ಷೆ ಬೇಡುವಂತಾಗು
ಪಲಾಯನ ಪಂಡಿತ	ಹೇಡಿ, ಕೈಲಾಗದವ
ಪಲ್ಟಿ ಹೊಡೆ	ಫೇಲಾಗು, ನಪಾಸಾಗು, ಅನುತ್ತೀರ್ಣನಾಗು
ಪಲ್ಲವಿ ಹಾಡು	ಹೇಳಿದ್ದನ್ನೇ ಮತ್ತೆ ಮತ್ತೆ ಹೇಳು
ಪಾಠ ಕಲಿಸು	ಬುದ್ಧಿ ಕಲಿಸು, ತಕ್ಕ ಶಾಸ್ತಿ ಮಾಡು
ಪಾದ ಬೆಳೆಸು	ಬರು, ದಯಮಾಡಿಸು, ಆಗಮಿಸು
ಪಾದರಸ	ಚುರುಕಾದ ವ್ಯಕ್ತಿ
ಪಾಪಾಸುಕಳ್ಳಿ	ದುಷ್ಟತನದಿಂದ ಕೂಡಿದವ, ಕೆಟ್ಟ ವ್ಯಕ್ತಿ
ಪಾರಾಯಣ ಮಾಡು	ಒಂದೇ ವಿಚಾರವನ್ನು ಮತ್ತೆ ಮತ್ತೆ ಹೇಳು
ಪಾರುಪತ್ಯ ನಡೆಸು	ಮೇಲ್ವಿಚಾರಣೆ ಮಾಡು, ಜಂಭದಿಂದ ನಡೆದುಕೊಳ್ಳು
ಪಿತ್ತ ತಲೆಗೇರು	ಕೋಪಗೊಳ್ಳು, ಅತಿಯಾಗಿ ಸಿಟ್ಟು ಮಾಡಿಕೊಳ್ಳು
ಪಿತ್ತ ನೆತ್ತಿಗೇರು	ಅತಿಯಾಗಿ ಕೋಪ ಮಾಡಿಕೊಳ್ಳು
ಪೀಕಲಾಟ	ಇಕ್ಕಟ್ಟಿನ ಪರಿಸ್ಥಿತಿ
ಪೀಠಿಕೆ ಹಾಕು	ಆರಂಭಿಸು, ಅನುಕೂಲಕರವಾದ ಸ್ಥಿತಿಯನ್ನು ಸಿದ್ಧಗೊಳಿಸು
ಪುಂಗಿ ಊದು	ಮರುಳು ಮಾಡು, ಪ್ರಭಾವ ಬೀರು
ಪುಕ್ಕ ಕತ್ತರಿಸು	ಗರ್ವ ಇಳಿಸು, ಹತೋಟಿಯಲ್ಲಿಡು
ಪುಚ್ಚ ಬಲಿ	ಶಕ್ತಿ ಹೆಚ್ಚಾಗು, ಸಾಮರ್ಥ್ಯ ಅಧಿಕವಾಗು
ಪುಟವಿಡು	ಪ್ರೋತ್ಸಾಹಿಸು, ಉತೆತೀಜನಗೊಳಿಸು
ಪುಡಿಯಾಳು	ಕೆಲಸಕ್ಕೆ ಬಾರದವ, ಅಪ್ರಯೋಜಕ
ಪುರಾಣ ತೆಗೆ	ಹಳೆಯ ವಿಷಯಗಳನ್ನು ಮತ್ತೆ ಮತ್ತೆ ಕೆದಕು
ಪುರಾಣ ಹೇಳು	ಅತಿಯಾಗಿ ಮಾತನಾಡು
ಪುರಳೆ ಹಚ್ಚಿಡು	ಜಗಳ ಹಚ್ಚು, ಮನಸ್ತಾಪವನ್ನು ಬೆಳೆಸು
ಪುಸ್ತಕದ ಬದನೇಕಾಯಿ	ಅನುಭವಕ್ಕೆ ಬಾರದ್ದು
ಪುಸ್ತಕದ ಹುಳು	ಸದಾಕಾಲ ಓದುತ್ತಿರುವವ, ವ್ಯವಹಾರ ಜ್ಞಾನ ಅರಿಯದವ
ಪೂಜೆಮಾಡು	ತಕ್ಕ ಶಾಸ್ತಿ ಮಾಡು, ಪಾಠ ಕಲಿಸು
ಪೂಸಿ ಮಾಡು	ಹೊಗಳು, ಮುದ್ದು ಮಾಡು, ರಮಿಸು, ಮರ್ಜಿ ಹಿಡಿ
ಪೆದ್ದಂಭಟ್ಟ	ಅತ್ಯಂತ ಪೆದ್ದ
ಪ್ರಪಂಚ ಕಾಣು	ಲೋಕಾನುಭವ ಹೊಂದು
ಪ್ರಮೀಳಾ ರಾಜ್ಯ	ಬರೀ ಹೆಂಗಸರಿಂದ ಕೂಡಿದ ಜಾಗ
ಪ್ರಾಣಕ್ಕೆ ಬರು	ವಿಪರೀತ ಕಷ್ಟವಾಗು, ತೊಂದರೆಯಾಗು
ಪ್ರಾಣ ಹಿಂಡು	ಬಹಳ ತೊಂದರೆ ಕೊಡು
ಪ್ರಾಣ ಹೋಗು	ಬಹಳ ಕಷ್ಟವಾಗು
ಪ್ರಾಯಕ್ಕೆ ಬರು	ಮೈನೆರು, ದೊಡ್ಡವಳಾಗು
ಫೇರಿ ಬಿಡು	ಓಡಿ ಹೋಗು, ಪಲಾಯನ ಮಾಡು
ಫೇರಿ ಹೊಡೆ	ಸುತ್ತಾಡು, ಸಂಚರಿಸು
ಬಂಗಾರದ ಪಂಜರ	ಸ್ವಾತಂತ್ರ್ಯವಿಲ್ಲದ ಸ್ಥಿತಿ
ಬಂಗಾರದ ಹೊಗೆಯಾಡು	ಸಮೃದ್ಧಿಯಾಗಿರು
ಬಂಗಾಳಿ ವಿದ್ಯೆ	ಮೋಸ, ವಂಚನೆ, ಠಕ್ಕತನ
ಬಂದ ದಾರಿ ಹಿಡಿ	ಮರಳಿ ಹೋಗು, ಹಿಂದಿರುಗು
ಬಕಧ್ಯಾನ	ಕಪಟ ಧ್ಯಾನ, ಮೋಸಗಾರಿಕೆ, ವಂಚನೆ
ಬಕರಾ	ಪೆದ್ದ, ದಡ್ಡ, ಮೂರ್ಖ
ಬಕಾಸುರ	ತಿನ್ನಾಸುಬಡಕ, ಹೆಚ್ಚು ತಿನ್ನುವವ, ಹೊಟ್ಟೆಬಾಕ
ಬಗಲಿಗೆ ಬೀಳು	ವಶವಾಗು, ಅಧೀನಕ್ಕೆ ಸಿಗು
ಬಗ್ಗು ಬಡಿ	ಬಾಯಿ ಮುಚ್ಚಿಸು, ಸುಮ್ಮನಿರಿಸು
ಬಟ್ಟ ಎಣಿಸು	ಲೆಕ್ಕ ಹಾಕು, ಎಣಿಸು
ಬಟ್ಟಲ ತಂಬುಲ	ಗೌರವಾರ್ಥವಾಗಿ ತಟ್ಟೆಯಲ್ಲಿ ಕೊಡುವ ವೀಳ್ಯ
ಬಡಪಟ್ಟಿಗೆ	ಸುಲಭವಾಗಿ, ಸರಾಗವಾಗಿ
ಬಡಾಯಿ ಕೊಚ್ಚು	ಜಂಬ ಹೊಡೆ
ಬಣ್ಣ ಕಟ್ಟಿ ಹೇಳು	ಅತಿಶಯವಾಗಿ ಹೇಳು, ಉತ್ಪ್ರೇಕ್ಷಿಸು
ಬಣ್ಣಗುಂದು	ಕಾಂತಿಹೀನವಾಗು, ಕಳೆಗುಂದು
ಬಣ್ಣದ ಮಾತು	ಬೂಟಾಟಿಕೆಯ ಮಾತು
ಬಣ್ಣ ಬದಲಾಯಿಸು	ಒಂದೊಂದು ಸಲ ಒಂದೊಂದು ತೆರನಾಗಿರು
ಬಣ್ಣ ಬಯಲಾಗು	ನಿಜ ಸ್ವರೂಪ ತಿಳಿ, ಮೋಸ ಹೊರಬೀಳು
ಬಣ್ಣ ಬಯಲಿಗೆ ಬರು	ಒಳಗುಟ್ಟು ರಟ್ಟಾಗು
ಬತ್ತಿಕೊಡು	ಮೋಸ ಮಾಡು, ವಂಚಿಸು
ಬತ್ತಿಯಿಡು	ಚಾಡಿ ಹೇಳು, ಹಚ್ಚಿಕೊಡು
ಬನ್ನೂರು ಕುರಿ	ಮೂರ್ಖ, ದಷ್ಟಪುಷ್ಟ
ಬರಹಿಡಿ	ಏನೂ ಸಿಗದಿರುವ ಸ್ಥಿತಿ
ಬರೆ ಎಳಿ	ನೋವನ್ನುಂಟು ಮಾಡು, ತೊಂದರೆ ಕೊಡು
ಬಲಗೈ	ಎಲ್ಲ ಕೆಲಸಗಳಲ್ಲಿ ಸಹಾಯ ಮಾಡುವವ, ಅತ್ಯಂತ ಆಪ್ತ
ಬಲಿಬೀಳು	ತುತ್ತಾಗು, ವಶವಾಗು
ಬಲಿಹಾಕು	ಶಿಕ್ಷಿಸು, ತಕ್ಕ ಶಾಸ್ತಿಮಾಡು
ಬಲೆಗೆ ಹಾಕಿಕೊಳ್ಳು	ವಶಕ್ಕೆ ತೆಗೆದುಕೊಳ್ಳು, ಅಧೀನ ಮಾಡಿಕೊಳ್ಳುವುದು
ಬಲೆ ಬೀಸು	ಪ್ರಯತ್ನಪಡು, ಹೊಂಚುಹಾಕು
ಬಲೆಗೆ ಬೀಳು	ಸಿಕ್ಕಿ ಹಾಕಿಕೊಳ್ಳು, ಬೇಸ್ತು ಬೀಳು
ಬಳೆ ತೊಡಿಸು	ಬಂಧಿಸು, ಕೊಳಹಾಕು
ಬಳೆ ತೊಡು	ಹೇಡಿಯಾಗು, ಗಂಡಸುತನ ಕಳೆದುಕೊಳ್ಳು
ಬಾಗಿಲುಕಾಯು	ಸೇವೆ ಮಾಡು, ಗುಲಾಮಗಿರಿ ಮಾಡು
ಬಾಗಿಲು ತೋರಿಸು	ಹೊರಗೆ ಕಳಿಸು
ಬಾಗಿಲು ಮುಚ್ಚು	ಪ್ರವೇಶ ನೀಡದಿರು
ಬಾದರಾಯಣ ಸಂಬಂಧ	ತುಂಬ ದೂರದ ಸಂಬಂಧ
ಬಾಯಲ್ಲಿ ನೀರೂರು	ಆಸೆ ಹುಟ್ಟು ಬಯಕೆಯಾಗು, ಅಪೇಕ್ಷೆಯಾಗು
ಬಾಯಲ್ಲಿ ಮಣ್ಣು ಬೀಳು	ನಾಶವಾಗು, ಹಾಳಾಗು
ಬಾಯಾಡಿಸು	ತಿನ್ನುತ್ತಿರು, ಮೆಲ್ಲುತ್ತಿರು
ಬಾಯಿ ಇಲ್ಲದವನು	ಸರಿಯಾಗಿ ಮಾತನಾಡಲು ಬರದವನು
ಬಾಯಿ ಕಟ್ಟು	ಪಥ್ಯ ಮಾಡು, ದಾಕ್ಷಿಣ್ಯಕ್ಕೆ ಸಿಗು, ನಿರುತ್ತರನನ್ನಾಗಿ ಮಾಡು
ಬಾಯಿ ಕೆಡು	ಜ್ವರಬರು, ತಿಂಡಿ ತೀರ್ಥಗಳು ರುಚಿಸದಿರು
ಬಾಯಿ ಕೊಚ್ಚು	ಜಂಬ ಕೊಚ್ಚಿಕೊಳ್ಳು
ಬಾಯಿಗೆ ತುತ್ತಾಗು	ನಿಂದೆಗೆ ಗುರಿಯಾಗು, ಮಾತಿಗೆ ಸಿಗು
ಬಾಯಿಗೆ ಬೀಗ ಹಾಕು	ಮಾತು ನಿಲ್ಲಿಸು, ಸುಮ್ಮನಿರು
ಬಾಯಿಗೆ ಬೀಳು	ನಿಂದೆಗೆ ಗುರಿಯಾಗು
ಬಾಯಿಗೆ ಮಣ್ಣಾಗು	ಹಾಳಾಗು, ನಾಶವಾಗು
ಬಾಯಿಗೆ ಮಣ್ಣು ಬೀಳು	ಜೀವಿಸಲು ತೊಂದರೆಯಾಗು
ಬಾಯಿ ಚಪಲ	ತಿನ್ನುವ ಬಯಕೆ, ಮಾತನಾಡುವ ಬಯಕೆ
ಬಾಯಿ ಚಪ್ಪರಿಸು	ತಿನ್ನಲು ಆಸೆಪಡು
ಬಾಯಿ ತಂಬುಲ	ಅನ್ಯರ ಋಣಭಾರ, ಬೇರೆಯವರ ಹಂಗು
ಬಾಯಿ ತೀಟೆ	ಬೇರೆಯವರನ್ನು ಬಯ್ಯುವ ಬಯಕೆ
ಬಾಯಿ ತುಂಬ	ಮನಃಪೂರ್ವಕವಾಗಿ
ಬಾಯಿ ತೆರೆ	ಮಾತನಾಡು, ಬಯಸು, ಹಂಬಲಿಸು
ಬಾಯಿಪಾಠ ಮಾಡು	ನೆನಪಿನಲ್ಲಿಟ್ಟುಕೊಳ್ಳಲು ಯತ್ನಿಸು, ಉರು ಹೊಡೆ
ಬಾಯಿ ಬಡಿ	ಬೇರೆಯವರಿಗೆ ಅವಕಾಶ ಕೊಡದಂತೆ ಮಾತನಾಡು
ಬಾಯಿ ಬಡುಕ	ಎದುರಾಳಿಗಳ ಬಾಯಿ ಮುಚ್ಚುವಂತೆ ಮಾಡನಾಡುವವ
ಬಾಯಿ ಬಾಯಿಬಿಡು	ಹಂಬಲಿಸು, ಇಚ್ಛಿಸು, ಬಯಸು
ಬಾಯಿ ಬಿಡು	ಆಶ್ಚರ್ಯಪಡು, ಮಾತನಾಡು, ಬಯಸು, ಇಚ್ಛಿಸು, ಯಾಚಿಸು, ಬೇಡು, ಬೇಡಿಕೊಳ್ಳು
ಬಾಯಿ ಮಾಡು	ಗದ್ದಲ ಮಾಡು, ಕಿರುಚಾಡು, ಕೂಗಾಡು
ಬಾಯಿ ಮಾತು	ನಂಬಲು ಅರ್ಹವಲ್ಲದ ಹೇಳಿಕೆ, ಆಧಾರವಿಲ್ಲದ ಹೇಳಿಕೆ
ಬಾಯಿಯ ಮೇಲೆ ಬೆರಳಿಡು	ಆಶ್ಚರ್ಯ ಚಕಿತನಾಗು, ವಿಸ್ಮಿತನಾಗು
ಬಾಯಿ ಸತ್ತವನು	ಹೆಚ್ಚು ಮಾತನಾಡದವ, ಸಂಕುಚಿತ ಸ್ವಭಾವದವ
ಬಾಯಿ ಸಿಹಿ ಮಾಡು	ಒಳ್ಳೆಯ ಸುದ್ದಿಯನ್ನು ನೀಡು
ಬಾಯಿ ಹರಿಬಿಡು	ಹಿಂದು ಮುಂದು ನೋಡದೆ ಮಾತನಾಡು
ಬಾಯಿ ಹಾಕು	ನಡುವೆ ಮಾತನಾಡು, ಮಧ್ಯ ಪ್ರವೇಶಿಸು
ಬಾಲಂಗೋಸಿ	ಹಿಂಬಾಲಕ, ಚೇಲಾ, ಅನುಯಾಯಿ
ಬಾಲ ಅಲ್ಲಾಡಿಸು	ಅತಿಯಾದ ವಿಧೇಯತೆಯನ್ನು ತೋರಿಸು
ಬಾಲ ಕತ್ತರಿಸು	ಗರ್ವವನ್ನು ಮುರಿ, ಸೊಕ್ಕು ಮುರಿ
ಬಾಲ ಬಡಿ	ಹೇಳಿದ್ದನ್ನು ಕೇಳು, ಮರ್ಜಿ ಹಿಡಿ
ಬಾಲ ಬಡುಕ	ಹಿಂಬಾಲಕ, ಅನಚರ, ಚೇಲಾ
ಬಾಲ ಬಿಚ್ಚು	ಕೀಟಲೆ ಮಾಡು, ತುಂಟಾಟ ಮಾಡು
ಬಾಲ ಮುದುರು	ನಮ್ರತೆಯಿಂದ ಇರು
ಬಾಲ ಹಿಡಿ	ಹಿಂಬಾಲಿಸು, ಅನುಸರಿಸು
ಬಾವುಟ ಹಾರಿಸು	ವಿಜಯವನ್ನು ಸೂಚಿಸು
ಬಾಸಿಂಗ ಬಲ	ಮದುವೆಯ ಯೋಗ
ಬಿಕೋ ಅನ್ನಿಸು	ಬೇಸರವಾಗು
ಬಿಗಿದು ಬರು	ದುಃಖ ಉಕ್ಕೇರಿ ಬರು, ಗದ್ದದವಾಗು
ಬಿಗಿ ಮುಷ್ಟಿ	ಭದ್ರವಾದ ಹಿಡಿತ
ಬಿಚ್ಚು ಮನಸ್ಸು	ಯಾವುದೇ ಮುಚ್ಚು ಮರೆಯಿಲ್ಲದ ಮನಸ್ಸು
ಬಿಟ್ಟಿ ಗಂಟು	ಪುಕ್ಕಟೆ ಸಿಗುವ ಹಣ
ಬಿಸಿ ತಟ್ಟು	ಅರಿವಿಗೆ ಬರು
ಬಿಸಿ ತಾಗಿಸು	ಚುರುಕು ಮುಟ್ಟಿಸು, ಅರಿವಿಗೆ ಬರುವಂತೆ ಮಾಡು
ಬಿಸಿ ತುಪ್ಪ	ಉಭಯ ಸಂಕಟ, ಇಕ್ಕಟ್ಟಿನ ಸ್ಥಿತಿ
ಬಿಸಿ ನೆತ್ತರು	ಯೌವನ, ಯುವಾವಸ್ಥೆ
ಬಿಸಿ ಮುಟ್ಟಿಸು	ಚುರುಕು ಮುಟ್ಟಿಸು, ಚುಚ್ಚು ಮಾತಿನಿಂದ ಸುಮ್ಮನಿರಿಸು
ಬಿಸಿಯಾಗು	ಉದ್ರೇಕಗೊಳ್ಳು, ಕಾವೇರು
ಬಿಸಿ ರಕ್ತ	ಯೌವನ, ಪ್ರಾಯ
ಬಿಸಿಲು ಕುದುರೆ	ಭ್ರಮೆ, ಕೈಗೆ ಸಿಗದ ವಸ್ತು
ಬಿಳಿಚಿಕೊಳ್ಳು	ಬಲಕಳೆದುಕೊಳ್ಳು, ನಿಸ್ತೇಜನಾಗು
ಬಿಳಿಯಾನೆ	ದುಬಾರಿಯಾದುದು, ಹೆಚ್ಚು ಬೆಲೆ ಬಾಳುವ
ಬೀದಿ ಕಾಮಣ್ಣ	ಪೋಕರಿ, ಕಾಮುಕ
ಬೀದಿಗೆ ಎಳೆ	ಅವಮಾನಕ್ಕೆ ಅವಕಾಶ ಕೊಡು
ಬೀದಿಗೆ ಬರು	ರಹಸ್ಯ ಹೊರಗೆ ಬರು
ಬೀದಿ ಕಾಳಗ	ಹೊರಗೆ ನಡೆಯುವ ಜಗಳ
ಬೀದಿ ಮಾತಾಗು	ರಹಸ್ಯ ಬಯಲಾಗು, ಎಲ್ಲರಿಗೂ ತಿಳಿ
ಬೀದಿಯ ಭಿಕಾರಿ	ತಿರುಕ, ದರಿದ್ರ
ಬುಟ್ಟಿಗೆ ಬೀಳು	ಅಧೀನವಾಗು, ವಶವಾಗು
ಬುಡಕ್ಕೆ ನೀರು ತಿದ್ದು	ನಾಶ ಮಾಡು, ಪೂರ್ಣ ಹಾಳು ಮಾಡು
ಬುಡ ಮೇಲಾಗು	ತಲೆಕೆಳಗಾಗು, ವಿಪರೀತವಾಗು
ಬುಡಮೇಲು ಮಾಡು	ಅಸ್ತವ್ಯಸ್ತಗೊಳಿಸು
ಬುನಾದಿ ಹಾಕು	ಆರಂಭ ಮಾಡು, ಆರಂಭಿಸು
ಬುರುಡೆ ಬಿಡು	ಸುಳ್ಳು ಹೇಳು, ಬೊಗಳೆ ಬಿಡು
ಬುರುಡೆ ಮಾತು	ಸುಳ್ಳು, ಮೋಸದ ಮಾತು
ಬೃಹಸ್ಪತಿ	ಮಹಾ ಪಂಡಿತ, ಮೇಧಾವಿ, ಬುದ್ಧಿವಂತ
ಬೆಂಕಿ ಕಾರು	ದ್ವೇಷ ಸಾಧಿಸು, ಹಗೆತನ ಸಾಧಿಸು
ಬೆಂಡೆತ್ತು	ತರಾಟೆಗೆ ತೆಗೆದುಕೊಳ್ಳು, ಹೊಡೆ, ಬಡಿ
ಬೆಕ್ಕಿನ ಸನ್ಯಾಸ	ಕಪಟ ಸನ್ಯಾಸ
ಬೆಕ್ಕು ಅಡ್ಡಬರು	ಅಪಶಕುನವಾಗು
ಬೆಚ್ಚಗೆ ಮಾಡು	ಲಂಚ ನೀಡು
ಬೆಟ್ಟು ಕಚ್ಚು	ಆಶ್ಚರ್ಯಪಡು, ಬೆರಗಾಗು
ಬೆಣ್ಣೆ ಮಾತು	ನಯವಾದ ಮಾತು, ಪುಸಲಾಯಿಸುವ ಮಾತು
ಬೆಣ್ಣೆ ಹಚ್ಚು	ಅನುನಯಿಸು, ಪುಸಲಾಯಿಸು, ನಯವಾಗಿ ಮಾಡು
ಬೆನ್ನಮೇಲೆ ಕೂರು	ಹಿಂಸಿಸು, ಪೀಡಿಸು
ಬೆನ್ನಲ್ಲಿ ಇರಿ	ಮರೆಯಲ್ಲಿದ್ದು ಮೋಸ ಮಾಡು, ವಿಶ್ವಾಸಘಾತ ಮಾಡು
ಬೆನ್ನಿಗೆ ಕಟ್ಟಿಕೊಳ್ಳು	ರಕ್ಷಣೆ ನೀಡು
ಬೆನ್ನು ಕಟ್ಟು	ಬೆಂಬಲ ನೀಡು, ಪಕ್ಷವಹಿಸು
ಬೆನ್ನು ಕಾಯು	ರಕ್ಷಿಸು, ಕಾಪಾಡು
ಬೆನ್ನು ಚಪ್ಪರಿಸು	ಹುರಿದುಂಬಿಸು, ಉತ್ಸಾಹ ನೀಡು, ಪ್ರೋತ್ಸಾಹಿಸು
ಬೆನ್ನು ತಟ್ಟು	ಉತ್ಸಾಹ ನೀಡು, ಪ್ರೋತ್ಸಾಹಿಸು, ಹುರಿದುಂಬಿಸು
ಬೆನ್ನು ತಿರುಗಿಸು	ವಿಮುಖನಾಗು
ಬೆನ್ನು ತೋರಿಸು	ಸೋತು ಹಿಂದಕ್ಕೆ ಹೋಗು, ಅಪಜಯ ಹೊಂದು
ಬೆನ್ನು ಬಲ	ಸಹಾಯ, ನೆರವು, ಆಸರೆ
ಬೆನ್ನು ಬಿಡು	ಸಹವಾಸವನ್ನು ಬಿಡು, ಸಹವಾಸವನ್ನು ತ್ಯಜಿಸು
ಬೆನ್ನು ಬೀಳು	ಹಿಂಬಾಲಿಸು, ದೈನ್ಯದಿಂದ ಹಿಂದೆ ಬೀಳು, ಶರಣಾಗತನಾಗು
ಬೆನ್ನು ಮೂಳೆ	ಆಧಾರ, ಮೂಲ
ಬೆನ್ನು ಸವರು	ಸಾಂತ್ವನಗೊಳಿಸು, ಸಮಾಧಾನಪಡಿಸು
ಬೆನ್ನು ಹತ್ತು	ಬಿಡದೇ ಹಿಂಬಾಲಿಸು, ಅನುಸರಿಸು
ಬೆನ್ನು ಹಾಕಿ ನಿಲ್ಲು	ಅಲಕ್ಷದಿಂದಿರು, ನಿರ್ಲಕ್ಷದಿಂದಿರು
ಬೆನ್ನು ಹಾಕು	ಮರಳಿ ಹೋಗು, ಹಿಂದಿರುಗು, ಮರಳು
ಬೆನ್ನು ಹಿಡಿ	ಅನುಸರಿಸು, ಹಿಂಬಾಲಿಸು
ಬೆನ್ನೆಲುಬು	ಆಧಾರ, ಮೂಲ
ಬೆರಳು ಕಚ್ಚಿಸು	ಆಶ್ಚರ್ಯಗೊಳಿಸು, ವಿಸ್ಮಯಗೊಳಿಸು, ಸೋಜಿಗಗೊಳಿಸು
ಬೆರಳು ಕಚ್ಚು	ಅಚ್ಚರಿಗೊಳ್ಳು, ವಿಸ್ಮಯಗೊಳ್ಳು
ಬೆರಳು ಚೀಪು	ಪ್ರತಿಭಟಿಸದೆ ಸುಮ್ಮನಿರು, ಎಳೆಮಗುವಿನಂತಿರು
ಬೆರಳು ಮುರಿ	ಶಪಿಸು, ಶಾಪ ಹಾಕು
ಬೆಲೆ ಬಾಳು	ಗೌರವವನ್ನು ಹೊಂದು, ಮಾನ್ಯತೆಯನ್ನು ಪಡೆ
ಬೆಲ್ಲವಾಗು	ಪ್ರಿಯವಾಗು, ಇಷ್ಟವಾಗು
ಬೆವರು ಸುರಿಸು	ಕಷ್ಟಪಡು, ಶ್ರಮಪಡು
ಬೆಳಕಿಗೆ ತರು	ಪ್ರಸಿದ್ಧಗೊಳಿಸು, ಪ್ರಕಾಶಕ್ಕೆ ತರು
ಬೆಳಕಿಗೆ ಬರು	ಪ್ರಸಿದ್ಧಿಯಾಗು
ಬೆಳಕು ಚೆಲ್ಲು	ಮಾಹಿತಿ ಕೊಡು, ಸ್ಪಷ್ಟಗೊಳಿಸು
ಬೆಳಕು ಬೀಳು	ಮಾಹಿತಿ ಸಿಗು, ಸ್ಪಷ್ಟವಾಗು
ಬೆಳಕು ಹರಿ	ಬೆಳಗಾಗು, ಸೂರ್ಯೋದಯವಾಗು
ಬೇಯಿಸಿ ಬಿಡು	ಕೊರಗುವಂತೆ ಮಾಡು, ದುಃಖಕ್ಕೀಡು ಮಾಡು
ಬೇಯು	ಸಂಕಟ ಪಡು, ಯಾತನೆ ಪಡು
ಬೇರು ಬಿಡು	ಸ್ಥಿರವಾಗಿ ನಿಲ್ಲು ತಳವೂರು
ಬೇರು ಸಹಿತ ಕೀಳು	ಪೂರ್ಣವಾಗಿ ನಾಶಪಡಿಸು
ಬೇರೂರು	ಸ್ಥಾಪನೆಗೊಳ್ಳು, ನೆಲೆಯೂರು, ತಳವೂರು
ಬೇವು ಬೆಲ್ಲ	ಕಷ್ಟಸುಖ
ಬೇಸ್ತುಬೀಳು	ಮೋಸಹೋಗು, ವಂಚನೆಗೊಳಗಾಗು, ಪೆಚ್ಚಾಗು
ಬೇಳೆಕಾಳು	ಯೋಗ್ಯತೆ, ಸಾಮರ್ಥ್ಯ
ಬೇಳೆ ಬೇಯು	ಯುಕ್ತಿ ಸಫಲವಾಗು, ಕಾರ್ಯಸಾಧನೆಯಾಗು
ಬೈರಿಗೆ ಹಿಡಿ	ಬೋರು ಮಾಡು, ಬೇಸರ ಪಡಿಸು
ಬೊಂಬಡ ಬಜಾಯಿಸು	ಬೊಬ್ಬೆ ಹಾಕು, ಕೂಗಾಡು
ಬೊಗಳುವ ನಾಯಿ	ಒಂದೇ ಸವನೆ ದೂಷಿಸುತ್ತಿರುವ ವ್ಯಕ್ತಿ
ಬೊಗಳೆ ಬಿಡು	ಸುಳ್ಳು ಹೇಳು
ಬೊಗಳೆ ಹೊಡೆ	ಹುಸಿಯಾಡು, ಸುಳ್ಳುಹೇಳು
ಬೊಟ್ಟು ಮುರಿ	ಶಾಪ ಹಾಕು
ಬೊಮ್ಮಡ ಹೊಡೆ	ಕೂಗಾಡು, ಬೊಬ್ಬೆ ಹಾಕು
ಬೋಡಾಗು	ಅಸಹಾಯಕನಾಗು, ನಿಸ್ಸತ್ವವಾಗು
ಬೋಳಿಸಿಕೊಳ್ಳು	ಕಳೆದುಕೊಳ್ಳು, ನಷ್ಟ ಮಾಡಿಕೊಳ್ಳು
ಬೋಳಿಸು	ನಾಶಪಡಿಸು, ಇಲ್ಲದಂತೆ ಮಾಡು
ಬ್ರಹ್ಮಗಂಟು	ಬಿಡಿಸಲಾಗದ ಗಂಟು
ಬ್ರಹ್ಮದಂಡ	ಪ್ರಬಲವಾದ ಅಸ್ತ್ರ
ಬ್ರಹ್ಮವಿದ್ಯೆ	ಕಷ್ಟಸಾಧ್ಯವಾದ ವಿದ್ಯೆ
ಬ್ರಹ್ಮಾಸ್ತ್ರ	ಅಂತಿಮ ಅಸ್ತ್ರ ಶಕ್ತಿಯುತವಾದ ಅಸ್ತ್ರ
ಭಗೀರಥ ಪ್ರಯತ್ನ	ಬಹಳ ಶ್ರಮದ ಪ್ರಯತ್ನ ಕಷ್ಟಕರ ಪ್ರಯತ್ನ
ಭಜನೆ ಮಾಡು	ವಟಗುಟ್ಟು
ಭಟ್ಟಿಯಿಳಿಸು	ನಕಲು ಮಾಡು, ಕಾಪಿ ಮಾಡು
ಭರತವಾಕ್ಯ	ಕೊನೆಯ ಮಾತು, ಕಡೆಯ ನುಡಿ
ಭಾರಹಾಕು	ಜವಾಬ್ದಾರಿಯನ್ನು ಹೊರಿಸು
ಭಾರ ಹೊರು	ಹೊಣೆಯನ್ನು ಹೊರು
ಭಾಷೆ ಕೊಡು	ಮಾತು ಕೊಡು, ವಾಗ್ದಾನ ಮಾಡು
ಭಾಷೆಗೆ ತಪ್ಪು	ಆಡಿದ ಮಾತನ್ನು ನಡೆಸದಿರು, ಕೊಟ್ಟ ಮಾತಿಗೆ ತಪ್ಪು
ಭಾಷೆ ಮುಟ್ಟಿಸು	ಕೊಟ್ಟಮಾತನ್ನು ಪೂರೈಸು, ವಾಗ್ದಾನವನ್ನು ನಡೆಸು
ಭಾಷೆ ಮುರಿ	ಭಾಷೆಗೆ ತಪ್ಪು ಕೊಟ್ಟಮಾತನ್ನು ಮರೆ
ಭೀಷ್ಮ ಪ್ರತಿಜ್ಞೆ	ಅಚಲವಾದ ಶಪಥ, ದೃಢವಾದ ಪಂಥ
ಭುಜ ಕುಣಿಸು	ಅಹಂಕಾರದಿಂದ ಮೆರೆ
ಭುಜ ಚಪ್ಪರಿಸು	ಪ್ರೋತ್ಸಾಹ ನೀಡು
ಭುಜ ತಟ್ಟಿಕೊಳ್ಳು	ಜಂಭ ಕೊಚ್ಚಿಕೊಳ್ಳು, ಆತ್ಮ ಪ್ರಶಂಸೆ ಮಾಡಿಕೊಳ್ಳು
ಭೂಗತ ಮಾಡು	ಹಾಳು ಮಾಡು, ನಾಶ ಮಾಡು
ಭೂತ ಬಡಿ	ದೆವ್ವ ಮೆಟ್ಟಿಕೊಳ್ಳು, ಹುಚ್ಚು ಹಿಡಿ
ಭೂಮಿಗಿಳಿದು ಹೋಗು	ಧೈರ್ಯಗುಂದು, ನಿರಾಶನಾಗು
ಭೂಮಿಗೆ ಭಾರ	ವ್ಯರ್ಥ ಜೀವಿ, ಅಪ್ರಯೋಜಕ
ಭೂಮಿ ತೂಕದ ಮನುಷ್ಯ	ಉದಾತ್ತ ವ್ಯಕ್ತಿ, ಅಪಾರವಾದ ಸಹನೆಯುಳ್ಳವನು
ಭೇದಿಗೆ ಕೊಡು	ಭಯವನ್ನುಂಟು ಮಾಡು, ಗಾಬರಿಪಡಿಸು
ಭೈರವಮೂರ್ತಿ	ಕೋಪಾವೇಶದ ವ್ಯಕ್ತಿ
ಮಂಕಾಗು	ಕಳೆಗುಂದು, ಬೇಸರ ಹೊಂದು
ಮಂಕುಕವಿ	ಬೇಸರಿಸು, ಕಳೆಗುಂದು
ಮಂಕುದಿನ್ನೆ	ಪೆದ್ವ ಮೂರ್ಖ
ಮಂಕುಬೂದಿ ಎರಚು	ಮೋಸಗೊಳಿಸು, ವಂಚಿಸು
ಮಂಗಮಾಯ	ಒಮ್ಮಿಂದೊಮ್ಮೆಲೆ ಕಾಣದಂತಾಗುವುದು
ಮಂಗಳ ಹಾಡು	ಮುಕ್ತಾಯ ಮಾಡು, ಸಮಾಪ್ತಿಗೊಳಿಸು
ಮಂಡೆ ಬೀಳು	ಸಾಯು, ಮರಣಿಸು
ಮಕ್ಕಳಾಟ	ಸುಲಭ ಕೆಲಸ, ಸರಳ ಕಾರ್ಯ
ಮಗ್ಗನೇಯು	ಚಾಡಿ ಹೇಳು, ಹಚ್ಚಿಕೊಡು
ಮಟ್ಟ ಹಾಕು	ಹಾಳು ಮಾಡು, ನಾಶಮಾಡು, ಮುಗಿಸು
ಮಡಿಲಲ್ಲಿ ಹಾಕು	ವಶಕ್ಕೆ ನೀಡು
ಮಡ್ಡಿ ಸಾಂಬ್ರಾಣಿ	ಬುದ್ಧಿಯಿಲ್ಲದವನು, ಮೂರ್ಖ
ಮಣೆ ಹಾಕು	ಮರ್ಯಾದೆ ಕೊಡು, ಗೌರವ ನೀಡು
ಮಣೆ ಹಿಡಿ	ಸೇವೆ ಮಾಡು, ಚಾಕರಿ ಮಾಡು
ಮಣ್ಣಾಗು	ಸಾಯು, ಮರಣಿಸು, ಕೇಡಾಗು
ಮಣ್ಣಿಗೆ ಹೋಗು	(ಸತ್ತವರ) ಸಂಸ್ಕಾರಕ್ಕೆ ಹೋಗು
ಮಣ್ಣುಗೂಡು	ನಾಶವಾಗು, ಹಾಳಾಗು
ಮಣ್ಣುತಿನ್ನು	ಹಿಂಸೆ ಅನುಭವಿಸು, ಕಷ್ಟಪಡು
ಮಣ್ಣು ತೂರು	ಶಪಿಸು, ಬೆಯ್ಯು,
ಮಣ್ಣು ಪಾಲಾಗು	ನಾಶಹೊಂದು, ಹಾಳಾಗು
ಮಣ್ಣು ಪಾಲು ಮಾಡು	ನಾಶಮಾಡು, ಹಾಳು ಮಾಡು
ಮಣ್ಣು ಮಾಡು	ಸಂಸ್ಕಾರ ಮಾಡು, ಸಮಾಧಿ ಮಾಡು, ಹೂಳು
ಮಣ್ಣು ಮುಕ್ಕಿಸು	ಸೋಲಿಸು, ಅಪಜಯಗೊಳಿಸು, ಪರಾಭವಗೊಳಿಸು
ಮಣ್ಣು ಮುಕ್ಕು	ಸೋಲು, ಪರಾಭವಹೊಂದು, ಕಷ್ಟಪಡು
ಮದುವೆ	(ವ್ಯಂಗ್ಯಾರ್ಥದಲ್ಲಿ) ಸರಿಯಾದ ಶಿಕ್ಷೆ ತಕ್ಕ ಶಾಸ್ತಿ ಮಾಡುವುದು
ಮಧ್ಯಾಹ್ನ ಮೀರು	ವಯಸ್ಸಾಗು, ಪ್ರಾಯವಾಗು
ಮನದಲ್ಲಿ ಮಂಡಿಗೆ ತಿನ್ನುವುದು	ಕಾಲ್ಪನಿಕ ಜೀವನ, ಅವಾಸ್ತವ ಸಂಗತಿಯನ್ನು ಚಿಂತಿಸುವುದು
ಮನಸ್ಸಿಗೆ ತೋರು	ಅನಿಸು, ಹೊಳೆ, ಅರಿವಾಗು
ಮನಸ್ಸಿಗೆ ಹಚ್ಚಿಕೊಳ್ಳು	ಚಿಂತಿಸು, ಬಹಳ ಚಿಂತೆಗೊಳಗಾಗು
ಮನಸ್ಸಿಗೆ ಹಿಡಿ	ಇಷ್ಟವಾಗು, ಮೆಚ್ಚು
ಮನಸ್ಸು ಕಲಕು	ಕೋಭೆಗೊಳ್ಳು, ಮನಸ್ಸಿಗೆ ತೊಂದರೆಯಾಗು, ಕಿರಿಕಿರಿಯಾಗು
ಮನಸ್ಸನ್ನು ಕಲ್ಲು ಮಾಡಿಕೊ	ಧೈರ್ಯ ತಾಳು, ಎದೆಗುಂದದಿರು
ಮನಸ್ಸು ಕೊರೆ	ಚಿಂತಿಸುವಂತೆ ಮಾಡು
ಮನಸ್ಸು ಗಟ್ಟಿ ಮಾಡು	ನಿಶ್ಚಿತವಾದ ಭಾವನೆಯನ್ನು ಹೊಂದು
ಮನಸ್ಸು ಬದಲಾಯಿಸು	ಬೇರೆ ಅಭಿಪ್ರಾಯವನ್ನು ಹೊಂದು
ಮನಸ್ಸು ಮಾಡು	ನಿರ್ಧಾರ ತೆಗೆದುಕೊಳ್ಳು
ಮನಸ್ಸು ಮುರಿ	ದ್ವೇಷವುಂಟಾಗು
ಮನಸ್ಸು ಸಣ್ಣಗಾಗು	ನೊಂದುಕೊಳ್ಳು, ನೋವನ್ನು ಅನುಭವಿಸು, ಚಿಂತೆಗೊಳಗಾಗು
ಮನಸ್ಸು ಹಣ್ಣಾಗು	ಪಳಗು, ಅನುಭವಸ್ತನಾಗು, ಅನುಭವ ಹೊಂದು
ಮನೆಗೆ ಕಳುಹಿಸು	ಅಮಾನತುಗೊಳಿಸು, ವಜಾಮಾಡು
ಮನೆತೊಳೆ	ಹಾಳುಮಾಡು, ನಾಶಮಾಡು
ಮನೆ ಪಾಲಾಗು	ಬೇರೆ ಬೇರೆಯಾಗು, ಪ್ರತ್ಯೇಕ ಸಂಸಾರ ಹೂಡುವುದು
ಮನೆ ಮಾಡು	ಮನಸ್ಸಿನಲ್ಲಿ ನೆಲೆನಿಲ್ಲು, ಬಿಡಾರ ಹೂಡು, ನೆಲೆಸು
ಮನೆ ಮಾತಾಗು	ಎಲ್ಲರಿಗೂ ತಿಳಿ, ಗೊತ್ತಾಗು
ಮನೆಮುರಿ	ನಾಶಮಾಡು, ಹಾಳು ಮಾಡು
ಮನೆಮುಳುಗಿಸು	ನಾಶಮಾಡು, ಹಾಳು ಮಾಡು
ಮನೆಯನ್ನು ನಿಲ್ಲಿಸು	ಉದ್ಧಾರ ಮಾಡು
ಮನೆಹಾಳು ವಿದ್ಯೆ	ಮನೆಯನ್ನು ನಾಶಮಾಡುವ ವಿದ್ಯೆ
ಮನೆಹೊಕ್ಕ ಮಾರಿ	ಅಪಾಯಕಾರಿ, ಅಹಿತಕಾರಿ
ಮರಳುಸೇತುವೆ	ಅಸ್ಥಿರತೆ, ಅಶಾಶ್ವತ
ಮರ್ಜಿಹಿಡಿ	ಅನುಗ್ರಹವನ್ನು ಸಂಪಾದಿಸು
ಮಲತಾಯಿ ಧೋರಣೆ	ಒಬ್ಬರಿಗೊಂದು ಇನ್ನೊಬ್ಬರಿಗೊಂದು ಮಾಡುವುದು, ಪಕ್ಷಪಾತ ಮಾಡುವುದು
ಮಸಿಬಳಿ	ಕಲಂಕವನ್ನುಂಟು ಮಾಡು
ಮಸಿಯಿಡು	ಕಳಂಕಗೊಳಿಸು
ಮಸ್ಕಾಹೊಡೆ	ಪೂಸಿ ಮಾಡು, ಪುಸಲಾಯಿಸು
ಮಾತಿಗೆ ಮಾತು ಬೆಳೆ	ಜಗಳವಾಗು, ಕಲಹವುಂಟಾಗು
ಮಾತಿನ ಮಲ್ಲ	ಅತಿಯಾಗಿ ಮಾತನಾಡುವವನು, ಹರಟೆಕೋರ
ಮಾತುಕೊಡು	ವಚನ ಕೊಡು, ವಾಗ್ದಾನ ಮಾಡು
ಮಾತು ತಪ್ಪು	ಕೊಟ್ಟಮಾತನ್ನು ಉಳಿಸಿಕೊಳ್ಳದಿರು
ಮಾತು ನಡೆ	ಪ್ರಭಾವ ಬೀರು
ಮಾತುಹಾರಿಸು	ವಿಷಯವನ್ನು ಬದಲಾಯಿಸಿ ಮಾತನಾಡು
ಮಾನಕಾಯು	ಮರ್ಯಾದೆಯನ್ನು ಉಳಿಸು, ಗೌರವ ಉಳಿಸು
ಮಾರಿಕಣ್ಣು	ಕ್ರೂರ ದೃಷ್ಟಿ ಕೆಟ್ಟ ದೃಷ್ಟಿ
ಮಾರ್ಜಾಲ ಸಂನ್ಯಾಸಿ	ಕಪಟಿ, ಮೋಸಗಾರ, ವಂಚಕ
ಮೀನಾಮೇಷ ಎಣಿಸು	ಖಚಿತ ನಿರ್ಧಾರಕ್ಕೆ ಬರದಿರು
ಮೀರ್ ಸಾಧಕ್	ವಿಶ್ವಾಸಘಾತಕ, ಮೋಸಗಾರ. ನಂಬಿಕೆದ್ರೋಹಿ, ವಂಚಕ
ಮೀಸೆ ತಿರುವು	ಅಹಂಕಾರ ಪಡು, ಕೊಚ್ಚಿಕೊಳ್ಳು, ಜಂಬಪಡು
ಮೀಸೆ ಮಣ್ಣಾಗು	ಅವಮಾನವಾಗು, ಅಪಮಾನ ಹೊಂದು
ಮೀಸೆ ಹೊರು	ಗಂಡಸುತನ ಹೊಂದು, ಪೌರುಷ
ಮುಂಡ ಮೋಚು	ಹಾಳಾಗು, ನಾಶವಾಗು
ಮುಂದಕ್ಕೆ ಬರು	ಉನ್ನತಿ ಹೊಂದು, ಏಳಿಗೆ ಹೊಂದು
ಮುಕ್ಕು ಮಾಡು	ನಾಶಮಾಡು, ಹಾಳುಮಾಡು
ಮುಖ ಅರಳು	ಖುಷಿಯಾಗು, ಸಂತೋಷವಾಗು
ಮುಖ ಊರಗಲ ಮಾಡು	ಅತಿಯಾದ ಆನಂದ ಹೊಂದು, ಬಹಳ ಸಂತೋಷವಾಗು
ಮುಖ ಕಪ್ಪಾಗು	ಅವಮಾನವಾಗು, ಕಳೆಗುಂದು
ಮುಖ ಕಿವಿಚು	ಅತೃಪ್ತಿಯನ್ನು ತೋರಿಸು, ಮುಖ ಸೊಟ್ಟಗೆ ಮಾಡು
ಮುಖ ಕೆಂಪಾಗು	ನಾಚು, ಸಂಕೋಚಪಡು
ಮುಖ ಕೆಳಗೆ ಹಾಕು	ತಲೆತಗ್ಗಸು, ಅವಮಾನ ಹೊಂದು
ಮುಖ ಕೊಡು	ಎದುರಿಸು, ನೇರವಾಗಿ ಮಾತನಾಡು
ಮುಖಕ್ಕೆ ಮಂಗಳಾರತಿ ಎತ್ತು	ಅವಮಾನ ಮಾಡು, ಛೀಮಾರಿ ಹಾಕು
ಮುಖಕ್ಕೆ ಹಿಡಿ	ಮಾಡಿದ ತಪ್ಪನ್ನು ಎತ್ತಿ ತೋರಿಸು
ಮುಖ ಗಂಟು ಹಾಕಿಕೊಳ್ಳು	ಸಿಡುಕು, ಮುಖ ಬಿಗಿದುಕೊಳ್ಳು, ಸಿಟ್ಟಾಗು
ಮುಖ ಚಿಕ್ಕದಾಗು	ಪೆಚ್ಚಾಗು, ಸಂಕುಚಿತನಾಗು
ಮುಖ ತಪ್ಪಿಸಿಕೊಳ್ಳು	ಕಣ್ಣಿಗೆ ಬೀಳದಂತೆ ಇರು
ಮುಖ ತಿವಿ	ತಿರಸ್ಕರಿಸು, ಅವಮಾನ ಮಾಡು
ಮುಖದ ಮೇಲೆಸೆ	ಎದುರೆದುರು ಖಂಡಿಸು, ನಿಂದಿಸು
ಮುಖ ನೋಡಿ ಮಣೆ ಹಾಕು	ಅಂತಸ್ತನ್ನು ನೋಡಿ ಗೌರವ ನೀಡು
ಮುಖ ಬಿಳಿಚಿಕೊಳ್ಳು	ಭಯಪಡು, ಸಂಕೋಚದಿಂದ ಕೂಡು
ಮುಖಭಂಗವಾಗು	ಅವಮಾನ ಹೊಂದು
ಮುಖ ಮುರಿ	ಅವಮಾನಗೊಳಿಸು
ಮುಖ ರಂಗೇರು	ನಾಚಿಕೊಳ್ಳು, ಸಂಕೋಚ ಹೊಂದು
ಮುಖ ಸಣ್ಣಗಾಗು	ಅವಮಾನವಾಗು
ಮುಖಸ್ತುತಿ	ಎದುರಿನಲ್ಲಿ ಹೊಗಳುವುದು
ಮುಖೇಡಿ	ಮುಖಕೊಟ್ಟು ಮಾತನಾಡದವನು
ಮುಗಿಲಿಗೇರಿಸು	ಅತಿಯಾಗಿ ಹೊಗಳು
ಮುಗಲ ಮಲ್ಲಿಗೆ	ದುರ್ಲಬವಾದುದು, ಕೈಗೆ ಸಿಗದ ವಸ್ತು
ಮುಗಿಲು ಮುಟ್ಟು	ಅತಿಯಾಗು, ಮೇಲೇರು
ಮುಟ್ಟಿದರೆ ಮುನಿ	ಸಂಕುಚಿತ ಪ್ರವೃತ್ತಿಯವನು
ಮುಟ್ಟಿದ್ದೆಲ್ಲ ಚಿನ್ನವಾಗು	ಒಳಿತಾಗು, ಅದೃಷ್ಟ ಬರು
ಮುಟ್ಟುಗೋಲು ಹಾಕು	ವಶಪಡಿಸಿಕೊಳ್ಳು, ಸ್ವಾಧೀನಕ್ಕ ತೆಗೆದುಕೊಳ್ಳು
ಮುದಿಗೊಡ್ಡು	ಹಳೆಯ ಕಂದಾಚಾರದವನು
ಮುದ್ರೆ ಒತ್ತು	ಒಪ್ಪಿಗೆ ಕೊಡು, ಸಹಮತಿ ನೀಡು, ಸಮ್ಮತಿಸು
ಮುಯ್ಯಿಗೆ ಮುಯ್ಯ	ಸೇಡಿಗೆ ಪ್ರತಿಸೇಡು, ಸೇಡು ತೀರಿಸಿಕೊಳ್ಳು
ಮುರಿದು ಬೀಳು	ನೆರವೇರದಿರು, ಪೂರೈಸದಿರುವುದು
ಮುರುಟಿ ಹೋಗು	ನಾಶವಾಗು, ಹಾಳಾಗು
ಮುಳುಗಿಸು	ವಂಚಿಸು, ಮೋಸಗೊಳಿಸು, ಹಾಳುಮಾಡು
ಮುಳ್ಳಾಗು	ಕಂಟಕಪ್ರಾಯವಾಗು, ತೊಂದರೆ ನೀಡು, ಅಡ್ಡಿಯಾಗು
ಮೂಗಿಗೆ ತುಪ್ಪ ಹಚ್ಚು	ಆಸೆಯನ್ನು ತೋರಿಸು, ಬಯಕೆ ಹುಟ್ಟಿಸು
ಮೂಗಿನ ಮೇಲೆ ಬೆರಳಿಡು	ಆಶ್ಚರ್ಯಹೊಂದು, ವಿಸ್ಮಯಹೊಂದು
ಮೂಗು ಕೆಳಗಾಗು	ಪ್ರತಿಷ್ಠೆ ಕಡಿಮೆಯಾಗು, ಅಗೌರವ ಹೊಂದು
ಮೂಗು ತೂರಿಸು	ಇನ್ನೊಬ್ಬರ ವಿಷಯದಲ್ಲಿ ತಲೆಹಾಕು,ಮಧ್ಯೆ ಪ್ರವೇಶಿಸು
ಮೂಗು ಮೇಲಾಗು	ಗೌರವ ಹೆಚ್ಚಾಗು, ಪ್ರತಿಷ್ಠೆ ಬೆಳೆ
ಮೂಗೆಳೆ	ನಿರುತ್ಸಾಹ ತೋರು
ಮೂರಾಬಟ್ಟೆಯಾಗು	ಹಾಳಾಗು, ನಾಶವಾಗು
ಮೂರುಕಾಸಿನವ	ಮರ್ಯಾದೆಗೆಟ್ಟವನು, ಗೌರವ ಕಳೆದುಕೊಂಡವನು
ಮೂರು ನಾಮ ಹಾಕು	ವಂಚಿಸು, ಮೋಸಮಾಡು, ನಂಬಿಸು ಮೋಸಗೊಳಿಸು
ಮೂಲೆಗುಂಪಾಗು	ಅನುಪಯುಕ್ತವಾಗು, ಕೆಲಸಕ್ಕೆ ಬಾರದಿರು, ಅಧಿಕಾರವನ್ನು ಕಳೆದುಕೊಳ್ಳು
ಮೂಲೆಗೆ ನೂಕು	ಬೆಲೆನೀಡದಿರು, ನಿರ್ಲಕ್ಷಿಸು
ಮೂಸಿನೋಡು	ವಿಚಾರಿಸಿಕೊಳ್ಳು, ಗಮನಿಸು
ಮೂಳೆ ಚಕ್ಕಳ	ಬಹಳ ಬಡವಾದ, ಕೃಶವಾದ
ಮೆಟ್ಟಿಲು ತುಳಿ	ಪ್ರವೇಶಿಸು, ಸೇರು, ಒಳಗೆ ಹೋಗು
ಮೆಟ್ಟಿನಿಲ್ಲು	ನಿಯಂತ್ರಿಸು, ಹತಿತಿತುಳಿ, ಮೀರಿ ನಿಲ್ಲು
ಮೆಟ್ಟಿ ಬೀಳು	ಬೆಚ್ಚಿಬೀಳು, ಭಯಪಡು
ಮೆಲುಕಾಡಿಸು	(ಹಿಂದಿನ ವಿಚಾರಗಳನ್ನು ನೆನಪಿಸಿಕೊಳ್ಳು
ಮೇಲಕ್ಕೆ ತರು	ಅಭಿವೃದ್ಧಿಗೊಳಿಸು
ಮೇಲುಗೈ	ಜಯ, ವಿಜಯ, ಗೆಲುವು
ಮೇಲು ಸಂಪಾದನೆ	ಲಂಚ, ಗಿಂಬಳ, ಹೆಚ್ಚಿನ ಆದಾಯ
ಮೇಲೆ ಬೀಳು	ಇಷ್ಟಪಡು, ತಾನಾಗಿಯೇ ಒಲಿದು ಬರು
ಮೇಲ್ಪಂಕ್ತಿ ಹಾಕು	ಮಾದರಿಯಾಗು, ಆದರ್ಶವಾಗು
ಮೈಕೆಡು	ಆರೋಗ್ಯದಲ್ಲಿ ಏರುಪೇರಾಗು
ಮೈಗಳ್ಳ	ಸೋಮಾರಿ, ಕೆಲಸಗಳ್ಳ
ಮೈಗೂಡಿಸು	ತನ್ನದನ್ನಾಗಿ ಮಾಡಿಕೊಳ್ಳು
ಮೈಗೆ ಹತ್ತು	ರಕ್ತಗತವಾಗು, ಹೊಂದಿಕೊಳ್ಳು
ಮೈಚಳಿ ಬಿಡು	ಭಯಬಿಡು, ಸಂಕೋಚವನ್ನು ಹೋಗಲಾಡಿಸು
ಮೈ ಜುಂ ಅನ್ನು	ರೋಮಾಂಚನವಾಗು
ಮೈ ತಣ್ಣಗಾಗು	ಸತ್ತು ಹೋಗು, ಮರಣಹೊಂದು
ಮೈ ತಿಳಿ	ಎಚ್ಚರಹೊಂದು
ಮೈತುಂಬಿಕೊಳ್ಳು	ದಷ್ಟಪುಷ್ಟವಾಗು
ಮೈನೆರೆ	ದೊಡ್ಡವಳಾಗು, ಪುಷ್ಪವತಿಯಾಗು, ಋತುಮತಿಯಾಗು
ಮೈ ಬಗ್ಗಿಸು	ಕಷ್ಟಪಡು, ಶ್ರಮಪಡು
ಮೈ ಬಿಸಿಯಾಗು	ಜ್ವರ ಬರು, ಮತ್ತೇರು, ನಶೆ ಬರು
ಮೈ ಬೆಂಕಿಯಾಗು	ಕೋಪಬರು, ಬಹಳ ಸಿಟ್ಟುಬರು
ಮೈಮರೆ	ಪರವಶವಾಗು, ಅನ್ಯಮನಸ್ಕನಾಗು
ಮೈ ಮುರಿದು ಕೆಲಸ ಮಾಡು	ಶ್ರಮವಹಿಸಿ ಕೆಲಸ ಮಾಡು, ಕಷ್ಟಪಟ್ಟು ದುಡಿ
ಮೈಮೆತತಿಗೆ ಮಾಡು	ಪಾಠಕಲಿಸು, ಚೆನ್ನಾಗಿ ಹೊಡೆ, ಥಳಿಸು
ಮೈ ಮೇಲೆ ಬರು	ದೆವ್ವ ಮೆಟ್ಟು ಭೂತ ಹಿಡಿ, ನಷ್ಟವಾಗು
ಮೈ ಮೇಲೆ ಬೀಳು	ಜವಾಬ್ದಾರಿ ಬೀಳು
ಮೈಮೇಲೆ ಹಾಕಿಕೊಳ್ಳು	ಜವಾಬ್ದಾರಿ ವಹಿಸು, ವಿರೋಧಕಟ್ಟಿಕೊಳ್ಳು
ಮೈ ಮೇಲೆ ಹಾಕು	ಜವಾಬ್ದಾರಿ ಹೊರಿಸು
ಮೈಯಿಕ್ಕು	ನಮಸ್ಕರಿಸು, ವಂದಿಸು
ಮೈಯೆಲ್ಲ ಕಣ್ಣಾಗು	ಅತಿಯಾದ ಜಾಗ್ರತೆ ವಹಿಸು, ಜಾಗರೂಕನಾಗಿರು
ಮೈಯೆಲ್ಲ ಕಿವಿಯಾಗು	ಜಾಗ್ರತೆ ವಹಿಸು, ಗಮನನೀಡು
ಮೈಹಿಡಿ	ದಷ್ಟಪುಷ್ಟವಾಗು
ಮೊದ್ದು ಮಣಿ	ಪೆದ್ದ ದಡ್ಡ
ಮೊಲದ ಕೊಂಬು	ಇಲ್ಲದಿರುವಿಕೆ, ಅಭಾವ, ಅಪರೂಪ
ಮೊಸಳೆ ಕಣ್ಣೀರು	ಸುಳ್ಳು ಕಣ್ಣೀರು, ಕಪಟ
ಮೊಳೆ ಹೊಡೆ	ಬೇಸರಗೊಳಿಸು
ಮೋಕ್ಷಆಗು	ಶಿಕ್ಷೆಯಾಗು, ಹೊಡೆತ ಬೀಳು
ಮೋಡಕವಿ	ಮಂಕಾಗು, ಲವಲವಿಕೆಯಿಲ್ಲದಿರು
ಮೋರೆ ಕೆಡಿಸು	ಅವಮಾನಗೊಳಿಸು
ಮೋರೆ ತಪ್ಪಿಸು	ಮರೆಯಾಗು, ಮುಖ ತಪ್ಪಿಸು
ಯಕ್ಷಪ್ರಶ್ನೆ	ಬಿಡಿಸಲಾಗದ ಪ್ರಶ್ನೆ, ಕಠಿಣ ಪ್ರಶ್ನೆ
ಯಜ್ಞಪಶು	ಮೋಸಕ್ಕೆ ಬಲಿಯಾಗುವ ವ್ಯಕ್ತಿ
ಯಮಭಾರ	ಅತಿಯಾದ ಭಾರವಿರುವ ವಸ್ತು
ಯಮಯಾತನೆ	ಅತಿಯಾದ ಹಿಂಸೆ, ತೀವ್ರವಾದ ಕಷ್ಟ
ರಂಗಾಗು	ಉತ್ಸಾಹ ಹೊಂದು, ಸಂತೋಷಪಡು
ರಂಗು ಮಾಡು	ಒಲಿಸಿಕೊಳ್ಳು
ರಂಗೇರು	ಕಳೆಗಟ್ಟು ನಾಚಿಕೆಯಿಂದ ಕೆನ್ನೆ ಕೆಂಪಾಗು
ರಂಗೋಲಿ ಕೆಳಗೆ ತೂರು	ಅತಿಯಾದ ಬುದ್ದಿವಂತಿಕೆ ತೋರು
ರಕ್ತಕುಡಿ	ಸೇಡು ತೀರಿಸಿಕೊಳ್ಳು
ರಕ್ತಕುದಿ	ಕೋಪಗೊಳ್ಳು, ಸಿಟ್ಟಾಗು, ರೌದ್ರವಾಗು
ರಕ್ತಗತವಾಗು	ಬಹಳ ಕಾಲದಿಂದ ಇರು
ರಕ್ತದ ಕಾಲುವೆ ಹರಿಸು	ಬಹಳ ಮಂದಿಯನ್ನು ಕೊಲ್ಲು
ರಕ್ತ ಬಸಿ	ಬಹಳ ಕಷ್ಟಪಡು
ರಕ್ತಸಂಬಂಧ	ಸೋದರಿಕೆ ಸಂಬಂಧ
ರಕ್ತ ಹಂಚಿಕೊಂಡವರು	ಒಂದೇ ತಾಯಿಯ ಮಕ್ಕಳು, ಸಹೋದರರು
ರಕ್ತ ಹೀರು	ತೊಂದರೆ ಕೊಡು, ಶೋಷಿಸು
ರಣಹದ್ದು	ಹಿಂಸಿಸುವವ, ಕಿತ್ತುತಿನ್ನುವವ
ರಾಗ ಎಳೆ	ರೋಧಿಸು, ದುಃಖಿಸು
ರಾಗ ಬದಲಾಯಿಸು	ಮಾತಿನ ರೀತಿಯನ್ನು ಬದಲಾಯಿಸು
ರಾಗಿ ಬೀಸು	ಕಷ್ಟಪಡು, ಶ್ರಮಪಡು, ಅನುಭವಪಡೆ, ಪ್ರಕ್ವಗೊಳ್ಳು
ರಾಜಕಾರ್ಯ	ದೊಡ್ಡ ಕಾರ್ಯ, ಮುಖ್ಯವಾದ ಕೆಲಸ
ರಾಜ ಮರ್ಯಾದೆ	ಗೌರವ, ಅತಿಯಾದ ಮನ್ನಣೆ
ರಾಜ್ಯಭಾರ	ಅಧಿಕಾರ, ಕಾರುಭಾರು
ರಾಮಬಾಣ	ಸರಿಯಾದ ಮದ್ದು ಸರಿಯಾದ ಉಪಾಯ
ರಾಮರಾಜ್ಯ	ಸುಖೀರಾಜ್ಯ
ರಾವಣ ರಾಜ್ಯ	ಕೆಟ್ಟ ಅಧಿಕಾರ, ಹಿಂಸಾ ಪ್ರವೃತ್ತಿ
ರಾವಣ ಸಂನ್ಯಾಸಿ	ಮೋಸಗಾರ, ವಂಚಕ, ಕಪಟಿ
ರುಚಿಸು	ಇಷ್ಟವಾಗು, ಮನಸ್ಸಿಗೆ ಬರು
ರೆಕ್ಕೆ ಕತ್ತರಿಸು	ಪ್ರಭಾವ ಕಳೆ, ಗೌರವ ಇಲ್ಲದಂತಾಗು
ರೆಕ್ಕೆ ಪುಕ್ಕ ಕಳೆದುಕೊಳ್ಳು	ಸಾಮರ್ಥ್ಯಕಳೆದುಕೊಳ್ಳು, ನಿರುಪಾಯನಾಗು
ರೆಕ್ಕ ಮೂಡು	ಉತ್ಸಾಹ ಹೆಚ್ಚಾಗು
ರೆಪ್ಪೆ ಭಾರವಾಗು	ನಿದ್ದೆ ಬರು, ತೂಕಡಿಕೆ ಬರು
ರೆಪ್ಪೆ ಹೊಡೆ	ಸಂಕೇತ ಮಾಡು, ಕಣ್ಣು ಸನ್ನೆ ಮಾಡು
ರೈಲು ಹತ್ತಿಸು	ಪೂಸಿ ಮಾಡು, ಪುಸಲಾಯಿಸು
ಲಂಕಿಣಿ	ಬಹಳ ಕೆಟ್ಟ ಹೆಂಗಸು, ಬಜಾರಿ
ಲಂಗು ಲಗಾಮು	ನಿರ್ಬಂಧ, ಪಟ್ಟು
ಲಂಗೋಟಿ ಸ್ನೇಹಿತ	ಬಾಲ್ಯಸ್ನೇಹಿತ, ಬಾಲ್ಯಮಿತ್ರ
ಲಕ್ಷ್ಮಣ ರೇಖೆ	ಮೀರಬಾರದ ಕಟ್ಟಳೆ
ಲಕ್ಷ್ಮೀಪುತ್ರ	ಶ್ರೀಮಂತ, ಹುಟ್ಟಿನಿಂದಲೇ ಸಿರಿವಂತಿಕೆಯಲ್ಲಿ ಬೆಳೆದವನು
ಲಗಾಮು ಹಾಕು	ಹತೋಟಿಯಲ್ಲಿಡು, ನಿರ್ಬಂಧಿಸು
ಲಹರಿ ಬರು	ಉತ್ಸಾಹ ಬರು, ಆನಂದವುಂಟಾಗು
ಲಾಗ ಹಾಕು	ಅತಿಯಾದ ಪ್ರಯತ್ನ ಪಡು, ನಪಾಸಾಗು
ಲಾಗ ಹೊಡೆ	ಬಹಳ ಪ್ರಯತ್ನ ಮಾಡು, ಸಾಯು, ಮರಣ ಹೊಂದು
ಲಾಟರಿ ಹೊಡೆ	ಬವಣೆ ಪಡು, ಕಷ್ಟದಲ್ಲಿರು
ಲಿಂಗೈಕ್ಯ	ಸತ್ತು ಹೋಗು, ಮರಣ ಹೊಂದು, ನಿಧನ ಹೊಂದು
ಲೀಲಾಜಾಲ	ಸುಲಭ, ನಿರಾಯಾಸ
ಲೆಕ್ಕಕ್ಕೆ ಬರು	ಗಣನೆಗೆ ಬರು, ಗಮನಕ್ಕೆ ಬರು
ಲೆಕ್ಕ ಹಾಕು	ಯೋಚಿಸು, ಊಹಿಸು
ಲೆಕ್ಕಾಚಾರ ಮಾಡು	ಪರಿಶೀಲಿಸು, ವಿಚಾರಿಸು
ಲೆಕ್ಕಾಚಾರ ಹಾಕು	ಆಲೋಚಿಸು, ಯೋಚಿಸು
ಲೇಪ ಹಾಕು	ಸಂತೈಸು, ಸಮಾಧಾನ ಮಾಡು
ಲೇವಡಿಯೆಬ್ಬಿಸು	ಗೇಲಿ ಮಾಡು, ಅಣಕಿಸು
ಲೋಕ ಕಂಡಿರುವವ	ಅನುಭವಿ, ಪಳಗಿದವ
ವಕ್ರಬುದ್ಧಿ	ಕುಟಿಲ ಸ್ವಭಾವ, ಕೆಟ್ಟ ಬುದ್ಧಿ
ವಕ್ರಿಸು	ಇಷ್ಟವಿಲ್ಲದಿದ್ದರೂ ಬರು, ಬೇಡವಾದ ಅತಿಥಿ
ವಜ್ರಕಾಯ	ದೃಢಕಾಯ, ಗಟ್ಟಿಮುಟ್ಟಾದ ವ್ಯಕಿತಿ
ವಜ್ರಮುಷ್ಟಿ	ಬಲವಾದ ಹಿಡಿತ
ವಜ್ರಾಘಾತ	ಒಮ್ಮಿಂದೊಮ್ಮೆಲೆ ಉಂಟಾಗುವ ಆಘಾತ
ವರಸೆ ತೆಗೆ	ನಿಜವಾದ ಸ್ವಭಾವವನ್ನು ವ್ಯಕ್ತಪಡಿಸು
ವಾಚಾಮಗೋಚರ	ಬಾಯಿಗೆ ಬಂದಹಾಗೆ, ಮನಸ್ಸಿಗೆ ಬಂದ ಹಾಗೆ (ಬಯ್ಯುವುದು)
ವಾಮನ ಮೂರ್ತಿ	ಕುಳ್ಳಗಿನ ವ್ಯಕ್ತಿ
ವಾಸನೆ ಹಿಡಿ	ವಿಷಯವನ್ನು ಅರಿ, ಜಾಡು ತಿಳಿ
ವಿಕೋಪಕ್ಕ ಹೋಗು	ಕೈ ಮೀರು, ಪರಿಸ್ಥಿತಿ ಹತೋಟಿ ತಪ್ಪು
ವಿಕ್ರಮ ಸಾಧಿಸು	ದಾಖಲೆಗಳನ್ನು ಮೀರು, ಸಾಧಿಸು
ವಿಚಾರಿಸಿಕೊಳ್ಳು	ಆಕ್ಷೇಪಿಸು, ತರಾಟೆಗೆ ತೆಗೆದುಕೊಳ್ಳು
ವಿಶ್ವಪ್ರಯತ್ನ ಮಾಡು	ಬಹಳಷ್ಟು ಶ್ರಮಪಡು, ತುಂಬ ಯತ್ನಿಸು
ವಿಶ್ವರೂಪ ತಾಳು	ನಾನಾ ತರಹದ ವೇಷ ಕಟ್ಟು
ವಿಷಕಕ್ಕು	ಅಸೂಯೆಪಡು, ಕರುಬು, ಹೊಟ್ಟೆಕಿಚ್ಚುಪಡು
ವೀಳ್ಯಕೊಡು	ಆಜ್ಞೆಮಾಡು, ಅಣತಿ ನೀಡು, ಆಹ್ವಾನಿಸು, ಗೌರವಯುತವಾಗಿ ಬರಮಾಡಿಕೊಳ್ಳು
ವೇದವಾಕ್ಯ	ಮೀರಬಾರದ ಮಾತು, ಪ್ರಮಾಣವಾದ ನುಡಿ
ಶಂಖ ಬಾರಿಸು	ಜೋರಾಗಿ ಕೂಗಾಡು, ಬೊಬ್ಬೆಯಿಡು,
ಶಂಖವಾದ್ಯ ಮಾಡು	ಜೋರಾಗಿ ಬಾಯಿ ಬಡಿದುಕೊಂಡು ಅಳು, ಬೊಬ್ಬೆಯಿಡು
ಶಂಖ ಹೊಡೆ	ಕೂಗಾಡು, ಬಾಯಿ ಬಡಿದುಕೊಳ್ಳು
ಶಕುನಿ	ಚಾಡಿಕೋರ, ಕೆಟ್ಟ ಮನುಷ್ಯ
ಶತಪಥ ಹಾಕು	ಅತ್ತಿಂದಿತ್ತನಡೆದಾಡು
ಶತಮೊಂಡ	ಬಹಳ ಹಟಮಾರಿ
ಶನಿ ಬಿಡಿಸು	ಚೆನ್ನಾಗಿ ಥಳಿಸು, ಹೊಡೆ, ಬುದ್ದಿ ಕಲಿಸು, ಗ್ರಹಚಾರ ಬಿಡಿಸು
ಶರಣು ಹೊಡೆ	ಮುಕ್ತಾಯ ಹಾಡು, ಸಮಾಪ್ತಿ ಮಾಡು, ಬಿಟ್ಟು ಬಿಡು
ಶಿವನ ಪಾದ ಸೇರು	ಮರಣಿಸು, ಸತ್ತು ಹೋಗು, ಐಕ್ಯನಾಗು
ಶಿವರಾತ್ರಿ	ಉಪವಾಸ
ಶಿವೈಕ್ಯನಾಗು	ಮರಣಿಸು, ಸಾಯು, ಮರಣ ಹೊಂದು
ಶೀತಲ ಸಮರ	ಮನದಲ್ಲಿಯೇ ದ್ವೇಷ ಸಾಧಿಸುವುದು, ಅಂತಃಕಲಹ
ಶುಕ್ರದೆಸೆ	ಏಳಿಗೆಯ ಕಾಲ, ಅದೃಷ್ಟ ಚೆನ್ನಾಗಿರುವ ಕಾಲ, ಅಭ್ಯುದಯ ಕಾಲ
ಶುದ್ಧಮೊದ್ದು	ಮೂರ್ಖ, ಅಜ್ಞಾನಿ
ಶ್ರುತಿ ಹಾಡು	ಅಳಲಾರಂಭಿಸು
ಷಡ್ಯಂತ್ರ	ಕಗ್ಗಂಟು, ಬಿಡಿಸಲಾಗದ ಬಲೆ, ತಪ್ಪಿಸಿಕೊಳ್ಳಲಾಗದಂತೆ ಮಾಡುವುದು, ತಂತ್ರಗಾರಿಕೆ
ಸಂತೆ ಮುಗಿ	ಸಮಯ ಮೀರು, ಕಾಲ ಕಳೆ
ಸಂಧ್ಯಾಕಾಲ	ಜೀವನದ ಮುಪ್ಪಿನ ಕಾಲ, ವಯಸ್ಸಾದ ಕಾಲ
ಸಂಬಂಧ ಬೆಳೆಸು	ನೆಂಟಸ್ತಿಕೆ ಮಾಡು, ಮದುವೆ ಸಂಬಂಧ ಗೊತ್ತು ಮಾಡು
ಸಂಸಾರ ತೂಗಿಸು	ಜೀವನ ನಿರ್ವಾಹ ಮಾಡು
ಸಂಸಾರ ಹೂಡು	ಹೊಸದಾಗಿ ಮನೆ ಮಾಡು, ಸಂಸಾರವನ್ನು ಆರಂಭಿಸು
ಸಕ್ಕರೆ ತುಪ್ಪದಲ್ಲಿ ಕೈ ತೊಳೆ	ಬಹಳ ಸುಖದ ಜೀವನ ನಡೆಸು, ಭೋಗದ ಜೀವನ
ಸಗಣಿ ಸಾರಿಸು	ಸಂಪೂರ್ಣವಾಗಿ ಹಾಳುಮಾಡು, ಸರ್ವನಾಶ ಮಾಡು
ಸಡಿಲು ಬಾಯಿ	ಬಾಯಿಯಲ್ಲಿ ಗುಟ್ಟು ನಿಲ್ಲದವ
ಸಡ್ಡು ಹೊಡೆ	ಪ್ರತಿಭಟಿಸು, ವಿರೋಧಿಸು
ಸತ್ತ ಹಾವು ಬಡಿ	ಹೇಡಿತನ, ಅಸಾಮರ್ಥ್ಯ
ಸತ್ತು ಸುಣ್ಣವಾಗು	ಸಾಕಷ್ಟು ಕಷ್ಟ ಅನುಭವಿಸು, ಬಹಳ ಕಷ್ಟಪಡು
ಸತ್ತು ಹುಟ್ಟು	ಸಂಕಟದಿಂದ ಪಾರಾಗು, ಅತೀವ ಕಷ್ಟದಿಂದ ಹೊರಗೆ ಬರು
ಸಪ್ಪೆಮುಖ	ಪೆಚ್ಚು ಮುಖ, ಗೆಲುವಿಲ್ಲದ ಮುಖ
ಸಮಾಧಿ ಮಾಡು	ನಾಶಮಾಡು, ಕೊಲ್ಲು ಸಂಹರಿಸು
ಸಮುದ್ರಕ್ಕೆ ನೀರು ಹೊರು	ವ್ಯರ್ಥಕಾರ್ಯ ಮಾಡು, ನಿಷ್ಟ್ರಯೋಜಕ ಕಾರ್ಯ ಮಾಡು
ಸರಕು ಬಿಚ್ಚು	ವಿವರವಾಗಿ ವಿಷಯವನ್ನು ಹೇಳುವುದು,
ಸರಸ್ವತೀ ಪುತ್ರ	ವಿದ್ವಾಂಸ, ಪಂಡಿತ, ಪಾಂಡಿತ್ಯವಿರುವವ
ಸರ್ಪಗಾವಲು	ಬಿಗಿಯಾದ ಕಾವಲು
ಸಲಾಮು ಹೊಡೆ	ತ್ಯಜಿಸು, ಬಿಟ್ಟು ಬಿಡು
ಸವಾರಿ ಮಾಡು	ಅಧಿಕಾರ ಚಲಾಯಿಸು, ದಬ್ಬಾಳಿಕೆ ನಡೆಸು
ಸವ್ಯಸಾಚಿ	ಅನೇಕ ವಿಷಯಗಳನ್ನು ಬಲ್ಲವನು,
ಸಹವಾಸ ದೋಷ	ಬೇರೆಯವರ ಒಡನಾಟದಿಂದ ಬರುವ ದೋಷ
ಸಾಕು ಬೇಕಾಗು	ಬಹಳ ಕಷ್ಟಪಡು
ಸಾಣೆ ಹಿಡಿ	ಮೆರಗು ಕೊಡು, ಕಾಂತಿಯನ್ನು ಹೆಚ್ಚಿಸು
ಸಾರಥ್ಯ	ಮಧ್ಯಸ್ಥಿಕೆ ವಹಿಸು
ಸಿಂಹಪಾಲು	ಹೆಚ್ಚಿನ ಭಾಗ, ಬಹಳಷ್ಟು ಅಧಿಕಾಂಶ
ಸಿಂಹಸ್ವಪ್ನ	ಹೆದರಿಕೆ ಬರಿಸುವಂತಹುದು, ಭಯಾನಕ
ಸಿಂಹಾವಲೋಕನ	ಮತ್ತೆ ಮತ್ತೆ ಹಿಂದಿನದನ್ನು ಗಮನಿಸಿ ಮುಂದುವರಿಯುವುದು
ಸಿಗಿದು ತೋರಣ ಕಟ್ಟು	ದಂಡಿಸು, ಶಿಕ್ಷಿಸು, ಸಾಯಿಸು, ಕೊಲ್ಲು
ಸಿಟ್ಟಿನ ಕೈಯ್ಯಲ್ಲಿ ಬುದ್ಧಿಕೊಡು	ಕೋಪದಲ್ಲಿ ಮನಸ್ಸನ್ನು ಹತೋಟಿಯಲ್ಲಿ ಇಟ್ಟುಕೊಳ್ಳದಿರುವುದು, ವಿವೇಚನೆಯನ್ನು ಕಳೆದುಕೊಳ್ಳುವುದು
ಸಿಟ್ಟು ನುಂಗಿಕೊಳ್ಳು	ಕೋಪವನ್ನು ತಡೆದುಕೊಳ್ಳು, ನಿಯಂತ್ರಿಸು, ನಿಗ್ರಹಿಸು
ಸಿಟ್ಟು ನೆತ್ತಿಗೇರು	ಅಧಿಕ ಕೋಪಗೊಳ್ಳು, ರೋಷಾವೇಶಗೊಳ್ಳು
ಸಿಡಿಲು ಬಡಿ	ಅನಿರೀಕ್ಷಿತ ಆಘಾತ, ದಿಕ್ಕು ತೋಚದ ಸ್ಥಿತಿ
ಸಿಡಿಲ ಮರಿ	ಬಹಳ ಚೂಟಿಯಾದ ವ್ಯಕ್ತಿ, ಪಾದರಸದಂತಹ ವ್ಯಕ್ತಿತ್ವ
ಸೀದು ಹೋಗು	ನಾಶವಾಗು, ಹಾಳಾಗು
ಸುಖದ ಸುಪ್ಪತ್ತಿಗೆ	ಸುಖದ ಜೀವನ ನಿರ್ವಹಣೆ
ಸುಟ್ಟ ಬದನೆ	ಕಳೆಕುಂದುವುದು, ಕಾಂತಿಹೀನವಾಗುವುದು
ಸುಟ್ಟ ಮೊಗ	ಸೋತ ಮುಖ, ಕೆಟ್ಟ ಮುಖ
ಸುಟ್ಟು ಸುಣ್ಣವಾಗು	ಬಳಲು, ಕಷ್ಟಪಡು
ಸುಡುಗಾಡಿಗೆ ಹೋಗು	ಹಾಳಾಗು, ನಾಶವಾಗು
ಸುತ್ತಿ ಬಳಸಿ ಮಾತಾಡು	ಹೇಳುವುದನ್ನು ನೇರವಾಗಿ ಹೇಳದಿರುವುದು
ಸುರಿಮಳೆ	ಅವಿರತ, ನಿರಂತರ
ಸುಲಿದ ಬಾಳೆಯ ಹಣ್ಣು	ಕಷ್ಟವಿಲ್ಲದಿರುವುದು, ಬಹಳ ಸುಲಭವಾದುದು
ಸುಳಿವು ಹಿಡಿ	ಪತ್ತೆ ಹಚ್ಚು ಜಾಡು ಹಿಡಿ
ಸೂಜಿಯಲ್ಲಿ ತುಪ್ಪ ಬಡಿಸು	ಜಿಪುಣತನ ತೋರಿಸು
ಸೂತ್ರದ ಗೊಂಬೆ	ಬೇರೆಯವರು ಹೇಳಿದಂತೆ ನಡೆದುಕೊಳ್ಳುವವನು
ಸೂರೆ ಹೋಗು	ಮರುಳಾಗು, ಆಕರ್ಷಿತನಾಗು
ಸೂರ್ಯವಂಶಿ	ಬಹಳ ನಿದ್ದೆ ಮಾಡುವವ, ನಿದ್ದೆಕೋರ
ಸೆಟೆದು ನಿಲ್ಲು	ಪ್ರತಿಭಟಿಸು, ಎದುರಿಸಿ ನಿಲ್ಲು ವಿರೋಧಿಸು
ಸೆಡ್ಡು ಹೊಡೆ	ಪ್ರತಿಭಟಿಸು, ವಿರೋಧಿಸು
ಸೆರಗಿನ ಕೆಂಡ	ಹತ್ತಿರದಲ್ಲೇ ಇರುವ ಅಪಾಯ
ಸೆರಗು ಹಾಸು	ವ್ಯಭಿಚಾರ ಮಾಡು, ಹಾದರ ನಡೆಸು
ಸೆರಗು ಹಿಡಿ	ಹಿಂಬಾಲಿಸು, ಆಶ್ರಯಕ್ಕೆ ಬರು
ಸೆರಗೊಡ್ಡಿ ಬೇಡು	ಅಂಗಲಾಚು, ದೈನ್ಯದಿಂದ ಬೇಡು
ಸೊಂಟ ಕಟ್ಟು	ಕಂಕಣಬದ್ಧನಾಗು, ಸಿದ್ಧನಾಗಿರು
ಸೊನ್ನೆ	ಏನೂ ಇಲ್ಲದಿರುವಿಕೆ
ಸೊನ್ನೆ ಬೀಳು	ನಾಶವಾಗು, ಇಲ್ಲವಾಗು
ಸೊನ್ನೆ ಸುತ್ತುತಿ	ಮೋಸಗೊಳಿಸು, ಇಲ್ಲದಂತೆ ಮಾಡು
ಸೊಪ್ಪುಹಾಕು	ಲಕ್ಷ್ಯ ನೀಡು, ಬೆಲೆಕೊಡು
ಸೊಲ್ಲು ಕರೆ	ಬೊಬ್ಬೆ ಹಾಕು, ಜೋರಾಗಿ ಕೂಗು
ಸೋತು ಸುಣ್ಣವಾಗು	ಬಳಲು, ವಿಪರೀತ ಕಷ್ಟಪಡು
ಸೋಸು	ಪರೀಕ್ಷಿಸು, ಗಮನವಿಟ್ಟು ನೋಡು
ಸ್ಮಶಾನಮೌನ	ನಿಶ್ಯಬ್ದವಾಗಿರುವಿಕೆ, ಸ್ವಲ್ಪವೂ ಗದ್ದಲವಿಲ್ಲದಿರುವಿಕೆ
ಸ್ವಂತಕಾಲ ಮೇಲೆ ನಿಲ್ಲು	ವೃತ್ತಿಗೆ ತೊಡಗು, ಸ್ವಾವಲಂಬಿಯಾಗು
ಸ್ವರ್ಗಕ್ಕೆ ಮೂರೇ ಗೇಣು	ಬಹಳ ಸಂತೋಷವನ್ನು ಹೊಂದು
ಹಕ್ಕಿನೋಟ	ಕಿರು ಪರಿಚಯ
ಹಚ್ಚಿಕೊಳ್ಳು	ಮನಸ್ಸಿಗೆ ಹತ್ತಿರವಾಗಿರಿಸಿಕೊಳ್ಳು
ಹಣೆಬರಹ	ಕಷ್ಟಕರ ಸ್ಥಿತಿ, ದುಃಸ್ಥಿತಿ, ಶೋಚನೀಯ ಸ್ಥಿತಿ
ಹಣೆ ಚಚ್ಚಿಕೊಳ್ಳು	ದುಃಖ ಉದ್ವೇಗದ ಸ್ಥಿತಿಗಳಲ್ಲಿ ಗೋಡೆಗೆ ಅಥವಾ ನೆಲಕ್ಕೆ ಹಣೆಯನ್ನು ಬಡಿದುಕೊಳ್ಳುವುದು, ಆವೇಶದ ಸ್ಥಿತಿ
ಹಣ್ಣಾಗು	ಮುದಿಯಾಗು, ಕಷ್ಟಪಡು, ಅನುಭವ ಹೊಂದು
ಹತ್ತರ ಕೂಡ ಹನ್ನೊಂದು	ಸಾಮಾನ್ಯ ಸ್ಥಿತಿ, ಯಾವುದೇ ಮಹತ್ವವಿಲ್ಲದ್ದು
ಹದಕ್ಕೆ ತರು	ಅಹಂಕಾರವನ್ನು ತಗ್ಗಿಸು, ಹೆಮ್ಮೆಯನ್ನು ಕಡಿಮೆಗೊಳಿಸು
ಹದ ಮಾಡು	ಸರಿಪಡಿಸು, ಅನುಕೂಲಕ್ಕೆ ತಕ್ಕಂತೆ ಬದಲಾಯಿಸು
ಹದಿನಾರಾಣೆ	ಪೂರ್ಣ ಪ್ರಮಾಣದ, ಅಪ್ಪಟ
ಹದ್ದಿನ ಕಣ್ಣು	ಕ್ರೂರ ನೋಟ, ಸೂಕ್ಷ್ಮ ನೋಟ
ಹದ್ದು ಮೀರು	ನಿಯಂತ್ರಣ ಮೀರು, ಅಂಕೆ ಮೀರು
ಹಬ್ಬಮಾಡು	ಶಿಕ್ಷೆ ನೀಡು, ದಂಡನೆ ನೀಡು
ಹರುಕು ಬಾಯಿ	ಬೇಕಾಬಿಟ್ಟಿಯಾಗಿ ಮಾತನಾಡುವವ
ಹರೆಟೆ ಕೊಚ್ಚು	ವ್ಯರ್ಥವಾಗಿ ಮಾತನಾಡು, ಕೆಲಸಕ್ಕೆ ಬಾರದ ಮಾತುಗಳನ್ನು ಆಡುವುದು
ಹರಟೆ ಮಲ್ಲ	ವಾಚಾಳಿ, ಹೆಚ್ಚು ಮಾತನಾಡುವವ
ಹರಾಜು ಹಾಕು	ಮಾನ ಕಳೆ, ಮರ್ಯಾದೆಗುಂದಿಸು
ಹರಿಬೀಳು	ಕೋಪಗೊಳ್ಳು, ಸಿಟ್ಟಿಗೇಳು, ಮೇಲೆ ಬೀಳು
ಹರಿ ಹಂಚು	ಚೂರು ಚೂರು, ದಿಕ್ಕು ಪಾಲಾಗು
ಹರಿಹಾಯು	ಕೋಪಗೊಳ್ಳು, ಮೇಲೆ ಬೀಳು, ಸಿಟ್ಟಿಗೇಳು
ಹಲ್ಲು ಉದುರಿಸು	ಚೆನ್ನಾಗಿ ಹೊಡೆ, ಥಳಿಸು, ಶಿಕ್ಷಿಸು, ದಂಡಿಸು
ಹಲ್ಲು ಕಚ್ಚಿಕೊಂಡಿರು	ಸುಮ್ಮನೆ ಸಹಿಸಿಕೊಂಡಿರು
ಹಲ್ಲು ಕಡಿ	ಕೋಪಿಸಿಕೊಳ್ಳು, ಸಿಟ್ಟು ಮಾಡಿಕೊಳ್ಳು
ಹಲ್ಲು ಕಿತ್ತ ಹಾವು	ನಿಸ್ಸತ್ವಗೊಂಡವನು, ಶಕ್ತಿಕಳೆದುಕೊಂಡವನು
ಹಲ್ಲು ಕಿರಿ	ದೈನ್ಯದಿಂದ ಬೇಡು, ಅಂಗಲಾಚು
ಹಲ್ಲುಗಿಂಜು	ದೈನ್ಯತೆ ತೋರುವುದು, ಅಂಗಲಾಚು
ಹಲ್ಲುಮನೆ	ದ್ವೇಷ ಸಾಧಿಸು, ಸೇಡು ತೀರಿಸಿಕೊಳ್ಳಲು ಹೊಂಚುಹಾಕು
ಹಲ್ಲು ಮುರಿ	ಗರ್ವ ಅಡಗಿಸು, ಸೊಕ್ಕು ಇಳಿಸು
ಹಲ್ಲು ಹಿಡಿದು ಮಾತನಾಡು	ಮಾತಿನಲ್ಲಿ ಹತೋಟಿಯಿರುವುದು, ನಾಲಗೆಯನ್ನು ಅಂಕೆಯಲ್ಲಿ ಇಟ್ಟುಕೊಳ್ಳುವುದು
ಹಸಿರು ಬಾವುಟ ತೋರಿಸು	ಆರಂಭಿಸು, ಆತಂಕಗಳನ್ನು ನಿವಾರಿಸು, ಶುಭ ಸೂಚಿಸು
ಹಸಿ ಸುಳ್ಳು	ಅಪ್ಪಟ ಸುಳ್ಳು, ಶುದ್ಧ ಸುಳ್ಳು
ಹಸ್ತಕ್ಷೇಪ	ಮತ್ತೊಬ್ಬರ ಕೆಲಸದಲ್ಲಿ ಮೂಗು ತೂರಿಸುವುದು, ಮಧ್ಯಪ್ರವೇಶಿಸುವುದು
ಹಳೇ ಹುಲಿ	ಬಹಳ ಕಾಲ ಕೆಲಸ ಒಂದೇ ರೀತಿಯ ಮಾಡಿದವನು, ಅನುಭವಶಾಲಿ
ಹಳ್ಳಕ್ಕೆ ಬೀಳು	ವಂಚನೆಗೊಳಗಾಗು, ಮೋಸ ಹೋಗು, ಬೇಸ್ತುಬೀಳು
ಹಾಡಿದ್ದನ್ನೇ ಹಾಡು	ಹೇಳಿದ್ದನ್ನೇ ಹೇಳು
ಹಾದಿ ಕಾಯು	ಎದುರು ನೋಡು, ಬರವನ್ನು ನಿರೀಕ್ಷಿಸು
ಹಾದಿಗೆ ಬರು	ಸರಿಯಾಗು, ಬದಲಾಗು, ಸರಿಯಾದ ಕ್ರಮಕ್ಕೆ ಬರು
ಹಾದಿಗೆ ಹಚ್ಚು	ಸರಿಯಾದ ಕ್ರಮದಲ್ಲಿ ನಡೆಸು, ಬದಲಾಯಿಸು
ಹಾದಿಗೆ ಹತುತಿ	ಸರಿಯಾಗು, ಬದಲಾಗು, ಸರಿಯಾದ ಕ್ರಮಕ್ಕೆ ಬರು
ಹಾದಿ ನೋಡು	ಎದುರು ನೋಡು, ಬರವನ್ನು ನಿರೀಕ್ಷಿಸು
ಹಾದಿಗೆ ಬೀಳು	ನಿರ್ಗತಿಕನಾಗು, ದಿಕ್ಕಿಲ್ಲದವನಾಗು, ಅನಾಥನಾಗು
ಹಾದಿ ರಂಪ	ಗಲಾಟೆ, ತಕರಾರು
ಹಾರಾಡು	ಅಹಂಕಾರ ತೋರಿಸು, ಆಡಂಬರ ಮಾಡು, ಜಂಬಕೊಚ್ಚು
ಹಾರಿಕೆ ಮಾತು	ಆಧಾರವಿಲ್ಲದ್ದು, ನಂಬಲಸಾಧ್ಯವಾದುದು
ಹಾರಿಕೆ ಸುದ್ದಿ	ಆಧಾರವಿಲ್ಲದ ಸುದ್ದಿ ನಂಬಲಸಾಧ್ಯವಾದುದು
ಹಾರಿ ಹೋಗು	ಓಡಿ ಹೋಗು, ಪಲಾಯನ ಮಾಡು
ಹಾರು ಹೊಡೆ	ಮನೆಯ ಬಾಗಿಲನ್ನು ಮುಚ್ಚದಿರುವುದು, ತೆಗೆದೇ ಇರು
ಹಾಲಿಗೆ ಹುಳಿ ಹಿಂಡು	ಹಾಳು ಮಾಡು, ಕೆಡಿಸು, ನಾಶಮಾಡು
ಹಾಲಿನಂಥ ಮನಸ್ಸು	ಪರಿಶುದ್ಧವಾದ ಮನಸ್ಸು ಕಪಟವರಿಯದ ಮನಸ್ಸು
ಹಾಲಿನಲ್ಲಿ ಕೈತೊಳೆ	ಶ್ರೀಮಂತಿಕೆ ಬರು, ಐಶ್ವರ್ಯವಂತನಾಗು
ಹಾಲು ಸಕ್ಕರೆ ಕುಡಿ	ಬಹಳ ಆನಂದ ಹೊಂದು, ಸಂತೋಷಗೊಳ್ಳು
ಹಾವು ಮುಂಗುಸಿ	ಬದ್ಧ ದ್ವೇಷದ ವ್ಯಕ್ತಿಗಳು
ಹಾಸಿಗೆಗೆ ಮೈಯೊಡ್ಡು	ನಿದ್ರಿಸು, ಮಗಲು, ವಿಶ್ರಾಂತಿ ತೆಗೆದುಕೊಳ್ಳು
ಹಾಸಿಗೆ ಹಿಡಿ	ರೋಗದಿಂದ ಬಳಲು, ಖಾಯಿಲೆಯಾಗು
ಹಾಳು ಕಣ್ಣು	ಕೆಟ್ಟ ದೃಷ್ಟಿ ಕ್ರೂರ ದೃಷ್ಟಿ
ಹಾಳು ನಾಲಿಗೆ	ಕೆಟ್ಟ ನಾಲಿಗೆ, ಹೇಳಿದ್ದೆಲ್ಲ ನಿಜವಾಗುವುದೆಂದು ನಂಬಲಾದ ನಾಲಿಗೆ
ಹಾಳುಭೂಮಿ	ಬಂಜರು ನೆಲ, ಬರಡು ನೆಲ
ಹಾಳು ಸುರಿ	ಬರಿದಾಗು, ಶೂನ್ಯವಾಗು
ಹಾಳು ಹಣೆ	ವೈಧವ್ಯದ ಸೂಚನೆ, ಬೋಳು ಹಣೆ
ಹಿಂಡಿ ತಿನ್ನು	ತೊಂದರೆ ಕೊಡು, ಹಿಂಸೆ ನೀಡು, ಕಾಟ ಕೊಡು
ಹಿಂಡಿ ಹಿಪ್ಪೆ ಮಾಡು	ಕುಗ್ಗಿಸು, ನಿಸ್ಸತ್ವಗೊಳಿಸು
ಹಿಂದಿಕ್ಕು	ಮುಂದೆ ಹೋಗು, ಮೊದಲಿಗನಾಗು
ಹಿಂದೆ ಬೀಳು	ಕೆಳಮಟ್ಟದಲ್ಲಿರು
ಹಿಂದೇಟು ಹಾಕು	ಅನುಮಾನಿಸು, ಹಿಂಜರಿ
ಹಿಗ್ಗಿ ಹೀರೇಕಾಯಿಯಾಗು	ಬಹಳ ಸಂತೋಷಗೊಳ್ಳು
ಹಿಟ್ಟು ಮಾಡು	ಚೆನ್ನಾಗಿ ಹೊಡೆ, ಹಣ್ಣು ಮಾಡು
ಹಿಡಿತ ತಪ್ಪು	ಕೈಮೀರು, ಹದಗೆಡು
ಹಿಡಿಸು	ಇಷ್ಟವಾಗು, ಒಪ್ಪಿಗೆಯಾಗು, ರುಚಿಸು
ಹಿತ್ತಾಳೆ ಕಿವಿ	ಚಾಡಿಮಾತುಗಳನ್ನು ಕೇಳುವ ಸ್ವಭಾವ
ಹೀನ ಸುಳಿ	ಕೆಟ್ಟ ಚಾಳಿ, ದುಷ್ಟ ಸ್ವಭಾವ
ಹುಡಿ ಹಾರಿಸು	ದುಂದು ವೆಚ್ಚಮಾಡು, ಆಡಂಬರದಿಂದ ಕಾರ್ಯ ಮಾಡು
ಹುಡುಗಾಟ	ಕುಚೇಷ್ಟೆ ಕುಚೋದ್ಯ
ಹುಬ್ಬು ಗಂಟಿಕ್ಕು	ಕೋಪಗೊಳ್ಳು, ಸಿಡಿಮಿಡಿಗೊಳ್ಳು
ಹುರಿದು ಮುಕ್ಕು	ಪೀಡಿಸು, ಗೋಳಾಡಿಸು
ಹುಲ್ಲುಕಡ್ಡಿ	ನಿಕೃಷ್ಟ ವ್ಯಕ್ತಿ, ಕೀಳು ಮನುಷ್ಯ
ಹುಳಿ ಹಿಂಡು	ಸ್ನೇಹ ಕೆಡಿಸು, ಸೌಹಾರ್ದ ಕೆಡಿಸು
ಹುಳಿಯಾಗು	ಕೆಟ್ಟುಹೋಗು, ಹಾಳಾಗು
ಹೂರಣ	ಗುಟ್ಟು ರಹಸ್ಯ, ತಿರುಳು
ಹೂವಿನ ಹಾಸಿಗೆ	ಸುಖಕರವಾದ ಜೀವನ, ಸುಗಮವಾದ ದಾರಿ
ಹೃದಯ ಕರಗು	ಕನಿಕರ ತೋರಿಸು, ದಯೆ ಉಂಟಾಗು
ಹೃದಯ ಕಲ್ಲಾಗು	ಕಠಿಣ ಮನಸ್ಸನ್ನು ಹೊಂದು, ನಿರ್ದಯತೆ ತೋರು
ಹೃದಯ ಭಾರವಾಗು	ಚಿಂತೆಗೊಳಗಾಗು, ಪರಿತಪಿಸು
ಹೃದಯವಂತಿಕೆ	ಉತ್ತಮ ಸ್ವಭಾವ, ವಿಶಾಲವಾದ ಮನಸ್ಸು
ಹೃದಯ ಹೀನ	ಕಟುಕ, ದಯೆಯಿಲ್ಲದವನು
ಹೆಂಗರುಳು	ಮೃದುಮನಸ್ಸು ಮಮತೆಯಿಂದ ಕೂಡಿದ ವ್ಯಕ್ತಿ
ಹೆಗಲ ಮೇಲೆ ಬೀಳು	ಜವಾಬ್ದಾರಿ ಹೊರು, ಹೊಣೆ ಬೀಳು
ಹೆಗಲ ಮೇಲೆ ಹೊರಿಸು	ಜವಾಬ್ದಾರಿ ನೀಡು
ಹೆಗಲ ಮೇಲೆ ಹೊರು	ಜವಾಬ್ದಾರಿ ಹೊರು, ಹೊಣೆ ಹೊರು
ಹೆಗಲು ಕೊಡು	ನೆರವಾಗು, ಸಹಾಯ ನೀಡು
ಹೆಗಲೇರು	ಹಿಂಬಾಲಿಸು, ಅನುಸರಿಸು
ಹೆಡೆಯಾಡಿಸು	ಮುಖ್ಯವಾಗಿ ಕಂಡುಬರು, ಎದ್ದು ಕಾಣು
ಹೆಣ ಕಾಯು	ಇಷ್ಟವಿಲ್ಲದ ಕೆಲಸ ಮಾಡು, ಪ್ರಯೋಜನಕ್ಕೆ ಬಾರದ ಕೆಲಸ ಮಾಡುವುದು
ಹೆಣ ಬಿದ್ದು ಹೋಗು	ಅತೀವ ಕಷ್ಟಕ್ಕೊಳಗಾಗು
ಹೆಣಭಾರ	ಬಹಳವಾದ ಹೊರೆ ಅತಿಯಾದ ಭಾರ
ಹೆಣ್ಣಿಗ	ನಪುಂಸಕ, ಪೌರುಷವಿಲ್ಲದವ, ಹೇಡಿ
ಹೆತ್ತೊತಿಡಲು	ತಾಯಿಯ ಕರುಳು, ಮಮತೆಯ ಹೃದಯ
ಹೆಬ್ಬೆಟ್ಟು	ಅನಕ್ಷರಸ್ಥ ಅಶಿಕ್ಷಿತ
ಹೆಸರಾಗು	ಪ್ರಸಿದ್ದಿಹೊಂದು, ಕೀರ್ತಿ ಪಡೆ
ಹೆಸರಿಗೆ ಮಸಿ ಬಳಿ	ಕಳಂಕತರು, ಅಪಕೀರ್ತಿಯನ್ನುಂಟು ಮಾಡು
ಹೆಸರಿಗೆ ಮಾತ್ರ	ನೆಪಕ್ಕ ಮಾತ್ರ, ತೋರಿಕೆಗೆ ಮಾತ್ರ
ಹೆಸರಿಲ್ಲವಾಗು	ಹಾಳಾಗು, ನಾಶವಾಗು
ಹೆಸರು ಉಳಿಸು	ಕೀರ್ತಿಯನ್ನು ಕಾಪಾಡಿಕೊಳ್ಳು, ಮರ್ಯಾದೆಯನ್ನು ಉಳಿಸು
ಹೆಸರು ಕಳೆದುಕೊಳ್ಳು	ಅಪಖ್ಯಾತಿಗೆ ಒಳಗಾಗು
ಹೆಸರು ಗಳಿಸು	ಕೀರ್ತಿಯನ್ನು ಗಳಿಸು, ಪ್ರಖ್ಯಾತಿ ಹೊಂದು
ಹೆಸರು ತರು	ಕೀರ್ತಿ ಪಡೆ, ಖ್ಯಾತಿ ಗಳಿಸು
ಹೆಸರು ಬರು	ಖ್ಯಾತಿ ಉಂಟಾಗು, ಪ್ರಸಿದ್ದಿ ಪಡೆ, ಅಪವಾದ ಬರು, ದೂಷಣೆ ಬರು
ಹೆಸರು ಮಾಡು	ಖ್ಯಾತಿ ಪಡೆ, ಪ್ರಸಿದ್ಧನಾಗು
ಹೇಳಿದ ಹಾಗೆ ಕುಣಿ	ಆಜ್ಞೆಯನ್ನು ಶಿರಸಾವಹಿಸಿ ಪಾಲಿಸು, ವಶವರ್ತಿಯಾಗು
ಹೊಂಚಿ ಕೇಳು	ಕದ್ದು ಕೇಳು, ಕದ್ದಾಲಿಸು
ಹೊಂಚು ಹಾಕು	ಅಡಗಿ ಕಾಯು, ಉಪಾಯ ಮಾಡು, ತಂತ್ರ ಮಾಡು
ಹೊಂಡಕ್ಕೆ ಹಾಕು	ಮಾಡಿದ್ದೆಲ್ಲ ವ್ಯರ್ಥವಾಗು, ಪ್ರಯೋಜನಕ್ಕೆ ಬಾರದಿರು
ಹೊಗೆಯಾಡು	ಒಳಗೊಳಗೆ ಕೋಪ ಹೆಚ್ಚಾಗು, ರೋಷ ವೃದ್ಧಿಯಾಗು
ಹೊಟ್ಟು ಕುಟ್ಟು	ಮಾಡಿದ್ದನ್ನೆ ಮತ್ತೆ ಮತ್ತೆ ಮಾಡು
ಹೊಟ್ಟೆ ಉರಿ	ಸಂಕಟವಾಗು, ದುಃಖವಾಗು, ಮತ್ಸರ, ಹೊಟ್ಟೆಕಿಚ್ಚು
ಹೊಟ್ಟೆ ಕಡಿ	ಅಸೂಯೆಯಾಗು, ಮತ್ಸರವುಂಟಾಗು
ಹೊಟ್ಟೆಗೆ ಹಾಕಿಕೊಳ್ಳು	ಕ್ಷಮಿಸು, ಮನ್ನಿಸು
ಹೊಟ್ಟೆ ತಣ್ಣಗಾಗು	ಸಮಾಧಾನವಾಗು, ತೃಪ್ತಿಯಾಗು
ಹೊಟ್ಟೆ ತಣ್ಣಗಿರು	ಸುಖವಾಗರು
ಹೊಟ್ಟೆ ತಾಳ ಹಾಕು	ಹಸಿವಾಗು
ಹೊಟ್ಟೆ ತೊಳಸು	ಅಸಹ್ಯವಾಗು, ವಾಂತಿಬರು
ಹೊಟ್ಟೆ ನೋವು	ಅಸೂಯೆ, ದ್ವೇಷ,
ಹೊಟ್ಟೆ ಪಾಡು	ಬದುಕುವ ಮಾರ್ಗ, ಜೀವನೋಪಾಯ
ಹೊಟ್ಟೆ ಮೇಲೆ ಬಡಿ	ಜೀವನಮಾರ್ಗವನ್ನು ಕೆಡಿಸು
ಹೊಟ್ಟೆಯ ಮೇಲೆ ಕಾಲಿಡು	ಜೀವನವನ್ನು ಹಾಳು ಮಾಡು
ಹೊಟ್ಟೆಯ ಮೇಲೆ ಹೊಡೆ	ಜೀವನೋಪಾಯವನ್ನು ಹಾಳು ಮಾಡು
ಹೊಟ್ಟೆಯಲ್ಲಿ ಹಾಕಿಕೊಳ್ಳು	ಕ್ಷಮಿಸು, ಮನ್ನಿಸು
ಹೊಟ್ಟೆಯುರಿ	ದ್ವೇಷ ಸಾಧಿಸು, ಅಸೂಯೆಪಡು, ಕರುಬು, ಮತ್ಸರ ಪಡು
ಹೊಟ್ಟೆ ಹೊರೆ	ಜೀವನಕ್ಕೆ ಮಾರ್ಗ ಕಂಡುಕೊಳ್ಳು, ಬದುಕು ಸಾಗಿಸು
ಹೊತ್ತು ನೆತ್ತಿಗೇರು	ಮಧ್ಯಾನ್ಹವಾಗು
ಹೊತ್ತು ಮುಳುಗು	ಸಂಜೆಯಾಗು
ಹೊರಗಾಗು	ರಸಜ್ವಲೆಯಾಗು, ಬೇರೆಯಾಗು, ಪ್ರತ್ಯೇಕವಾಗು
ಹೊಸಿಲು ಮೆಟ್ಟು	ಒಳಗಡೆ ಬರು, ಮನೆಯನ್ನು ಪ್ರವೇಶಿಸು
ಹೊಸಿಲು ದಾಟು	ಮನೆ ಬಿಟ್ಟು ಹೋಗು
ಹೋಗೋ ಕಾಲ	ಸಾಯುವ ಕಾಲ, ಅಂತಿಮ ಸಮಯ
ಹೋಳಿಗೆ ಹಾಕಿಸು	ಮದುವೆ ಮಾಡಿಕೊಳ್ಳು. ಮದುವೆ ಮಾಡು
ಹೌದಪ್ಪ	ಸ್ವಂತ ಅಭಿಪ್ರಾಯವಿಲ್ಲದವ, ಹೇಳಿದ್ದಕ್ಕೆಲ್ಲ ಹೌದು ಹೌದು ಎನ್ನುವವ
ಅ ಆ ಇ ಈ	ಮೊದಲ ಪಾಠ
ಅಕ್ಷರ ಶತ್ರು	ಓದು-ಬರಹದಲ್ಲಿ ಆಸಕ್ತಿಯಿಲ್ಲದವ
ಅಚ್ಚಳಿಯದೆ ಇರು	ಮರೆಯದೆ ಉಳಿ
ಅಜರಾಮರವಾಗಿರು	ಶಾಶ್ವತವಾಗಿರು
ಅಜ್ಜಿಪುರಾಣ	ಕಟ್ಟುಕಥೆ
ಅಡಿಪಾಯ ಹಾಕು	ನೆಲೆಗೊಳಿಸು
ಅಡ್ಡ ದಾರಿ ಹಿಡಿ	ತಪ್ಪು ಕೆಲಸ ಮಾಡು
ಅಯಸ್ಕಾಂತದಂತಿರು	ಆಕರ್ಷಕ ವ್ಯಕ್ತಿತ್ವ
ಅರಣ್ಯರೋದನ	ಯಾರ ಕಿವಿಗೂ ಬೀಳದಿರುವ ಮೊರೆ
ಅರಳು ಹುರಿದ ಹಾಗೆ	ಒಂದೇ ಸಮನೆ
ಅಳಿಲು ಸೇವೆ	ನಿಷ್ಠೆಯಿಂದ ಮಾಡುವ ಅಲ್ಪಸೇವೆ
ಆಕಾಶ ಕಳಚಿಬೀಳು	ದೊಡ್ಡ ಆಘಾತ ಸಂಭವಿಸು
ಆಲಾಲುಟೋಪಿ	ಮೋಸ ಮಾಡುವವನು
ಇಂಗಿ ಹೋಗು	ಮುಗಿ, ಬತ್ತು
ಇಂಗು ತಿಂದ ಮಂಗ	ಮೋಸ ಹೋಗು
ಇಕ್ಕಳದಲ್ಲಿ ಸಿಕ್ಕಿಸು	ತೊಂದರೆಗೆ ಈಡುಮಾಡು
ಇತಿಶ್ರೀ	ಮುಕ್ತಾಯ
ಉಪ್ಪು ಹಾಕು	ಪ್ರಚೋದಿಸು
ಊರುಕೇರಿ ಒಂದು ಮಾಡು	ಕಿತ್ತಾಡು
ಎಂಜಲಿಗೆ ಕೈ ಒಡ್ಡು	ಹಂಗಿಗೊಳಗಾಗು
ಎಕ್ಕುಟ್ಟಿ ಹೋಗು	ಹಾಳಾಗು
ಎಡಗೈ ಹೆಬ್ಬೆರಳಿನ ಪಂಡಿತ	ನಿರಕ್ಷರ ಕುಕ್ಷಿ
ಎತ್ತಂಗಡಿ	ವರ್ಗಾವಣೆ ಮಾಡು
ಎತ್ತಿ ಕಟ್ಟು	ಚಾಡಿ ಹೇಳು
ಎತ್ತಿದ ಕೈ	ಪಂಡಿತ
ಎದೆ ಎದೆ ಬಡಿದುಕೊ	ದುಃಖಿಸು
ಎದೆ ಗಟ್ಟಿ ಮಾಡಿಕೊ	ಧೈರ್ಯ ತಾಳು
ಎದೆಯೊಡೆದು	ಬಹಳ ದುಃಖವಾಗು
ಎಮ್ಮೆ ಚರ್ಮದವ	ಟೀಕೆಗಳ ಪರಿಣಾಮ ಆಗದವ
ಎಲೆಮರೆ ಕಾಯಿ	ಯಾವುದೇ ಪ್ರತಿಫಲ ಬಯಸದೇ ಕೆಲಸ ಮಾಡುವವ
ಎಳ್ಳುನೀರು ಬಿಡು	ಶಾಶ್ವತವಾಗಿ ಆಸೆ ಬಿಡು
ಏತಿ ಅಂದ್ರೆ ಪ್ರೇತಿ	ಎಲ್ಲದಕ್ಕೂ ವಿರೋಧ
ಒಣ ಪಾಂಡಿತ್ಯ	ಕೆಲಸಕ್ಕೆ ಬಾರದವ
ಒನಕೆ ಚಿಗುರು	ಅಸಾಧ್ಯವಾದುದು ಆಗುವುದು
ಒರೆ ಹಚ್ಚು	ಚೆನ್ನಾಗಿ ಪರೀಕ್ಷಿಸು
ಓಬಿರಾಯನ ಕಾಲ	ಹಳೆಯ ಕಾಲ
ಕಂಬ ಸುತ್ತು	ವ್ಯರ್ಥವಾಗಿ ಕೆಲಸ ಮಾಡು
ಕಂಬಿ ಎಣಿಸು	ಕಾರಾಗೃಹ ವಾಸ
ಕಗ್ಗಂಟು	ಬಿಡಿಸಲಾಗದ ಸಮಸ್ಯೆ
ಕಣಕ್ಕೆ ಇಳಿ	ಹೋರಾಡು
ಕಣ್ಣಿಗೆ ಅಂಜನ ಹಾಕು	ಸ್ಪಷ್ಟವಾಗಿ ಅರಿವಾಗು
ಕಣ್ಣಿಗೆ ಆಹಾರವಾಗು	ನೋಡುವಂತಾಗು
ಕಣ್ಣಿಗೆ ಎಣ್ಣೆ ಹಾಕಿಕೊ	ಎಚ್ಚರವಾಗಿರು
ಕಣ್ಣಿನಲ್ಲಿ ಗಂಗಾವತಾರವಾಗು	ಆನಂದಭಾಷ್ಪ
ಕಣ್ಣೀರಿನಲ್ಲಿ ಕೈ ತೊಳೆ	ಕಷ್ಟವನ್ನು ಅನುಭವಿಸು
ಕಣ್ಸವಿ	ಇಷ್ಟವಾದ ನೋಟ
ಕತ್ತೆ ಕಾಯಿ	ಸೋಮಾರಿತನ
ಕಲ್ಲುನೀರು ಕರಗುವ ಹೊತ್ತು	ಮಧ್ಯರಾತ್ರಿ
ಕಾಗೆ ಮುಳುಗು	ಸ್ನಾನದ ಶಾಸ್ತ್ರ ಮಾಡು
ಕಾಲ ಕಸ	ಬೆಲೆಯಿಲ್ಲದ
ಕಾಲಗುಣ	ಶಕುನ
ಕಾಲಲ್ಲಿ ಹಾವು ಬಿಡು	ಗೊಂದಲಪಡಿಸು
ಕಾಲಿಗೆ ಬುದ್ದಿ ಹೇಳು	ಓಡಿ ಹೋಗು
ಕಿರೀಟಪ್ರಾಯ	ಭೂಷಣವಾಗಿರು
ಕಿವಿ ಸೋಲು	ಕೇಳು, ನಂಬು
ಕಿವಿಯಳತೆ	ಕೇಳುವಷ್ಟು ದೂರ
ಕಿಷ್ಕಂದೆ	ಇಕ್ಕಟ್ಟಾದ ಜಾಗ
ಕುಂತೀ ಮಕ್ಕಳ ಸಂಸಾರ	ಕಷ್ಟದ ಜೀವನ
ಕುಲಗೇಡು	ನಾಶವಾಗು
ಕೃಷ್ಣಲೀಲೆ	ವ್ಯಭಿಚಾರ
ಕೆಂಡ ಕಾರು	ಬಹಳ ಕೋಪ ಮಾಡಿಕೋ
ಕೈ ಕಂಡ ಕೆಲಸ	ತನಗೆ ತಿಳಿದಿರುವ ಕೆಲಸ
ಕೈ ಕಚ್ಚು	ನಷ್ಟವಾಗು
ಕೈ ಕೈ ಮಿಲಾಯಿಸು	ಹೊಡೆದಾಟ ಆಗು
ಕೈ ಕೊಸರು	ಮನಸ್ತಾಪವಿರು
ಕೈ ತವಕ	ಕೈ ಚಪಲ
ಕೈ ತೊಳೆದು ಮುಟ್ಟು	ಸುಂದರವಾಗಿರು
ಕೈ ನೋಡು	ಶಕ್ತಿ ಪರೀಕ್ಷಿಸು
ಕೈ ಬಾಯಿ ಶುದ್ಧವಿರು	ಮಾತು ಚೆನ್ನಾಗಿರು
ಕೈ ಬೀಸಿ	ಕರೆ, ಆಕರ್ಷಕವಾಗಿರು
ಕೈ ಮುರಿದಂತಾಗು	ಅಸಹಾಯಕ ಪರಿಸ್ಥಿತಿ
ಕೈ ಹರಿತ ಆಗು	ಅನುಭವಿಯಾಗು
ಕೈಕಾಲು ಹಿಡಿ	ಅಂಗಲಾಚು
ಗಂಟಲಲಿ ಕಡುಬು ತುರುಕು	ಬಲಾತ್ಕಾರವಾಗಿ ಒಪ್ಪಿಸು
ಗಂಟು ಮಾಡು	ಸಂಪಾದಿಸು
ಗಗನ ಕುಸುಮ	ಕೈಗೆಟುಕದೆ ಇರುವುದು, ಅಸಾಧ್ಯವಾದುದು
ಗಣಪತಿ ಮದುವೆ	ಆಗದಿರುವ ಮದುವೆ
ಗತಿ ಕಾಣಿಸು	ಮುಗಿಸಿಬಿಡು
ಗಾಳಿಗೆ ಗರಿ ಮೂಡು	ಶೀಘ್ರತೆ ಹೆಚ್ಚಾಗು
ಗಾಳಿಗೆ ತೂರಿಬಿಡು	ನಿರ್ಲಕ್ಷಿಸು
ಗಾಳಿಮಾತು	ಸುಳ್ಳು ಸುದ್ದಿ
ಗೂಸಾ ಹಾಕು	ಥಳಿಸು
ಗೆದ್ದೆತ್ತಿನಬಾಲ ಹಿಡಿ	ಸಮಯ ಸಾಧಕತನ
ಗ್ರಹಣ ಹಿಡಿದಂತಾಗು	ದಿಕ್ಕೆಡು
ಘಂಟಾಘೋಷ	ನಿರ್ಧಾರವಾಗಿ ಹೇಳು
ಚಟ್ಟಿ ಮಾಡು	ಚೆನ್ನಾಗಿ ಹೊಡೆ
ಚಪ್ಪಡಿ ಎಳೆ	ಹಾಳು ಮಾಡು
ಚಳ್ಳೆ ಹಣ್ಣು ತಿನ್ನಿಸು	ವಂಚಿಸು
ಚಾತಕಪಕ್ಷಿಯಂತೆ ಕಾಯು	ದೀರ್ಘಕಾಲ ನಿರೀಕ್ಷಿಸು
ಚೇಳಿನ ವಿಷದಂತೆ	ಶೀಘ್ರವಾಗಿ ಏರು
ಛೀ ಅನ್ನಿಸಿಕೊ	ಅವಮಾನಕ್ಕೆ ಗುರಿಯಾಗು
ಛೂ ಬಿಡು	ಮೇಲೆ ಬೀಳಲು ಹುರಿದುಂಬಿಸು
ಜಾಲ ಬೀಸು	ವಂಚಿಸಲು ಯತ್ನಿಸು
ಜೀವ ತುಂಬು	ಶಕ್ತಿ ಕೊಡು
ಠೇವಣಿ ಕಳೆದುಕೊ	ನಾಶವಾಗು
ತಣ್ಣೀರೆರಚು	ಉತ್ಸಾಹವನ್ನು ಕುಗ್ಗಿಸು, ಉತ್ಸಾಹಕ್ಕೆ ಕುಂದು ಬರಿಸು
ತಲೆ ಎತ್ತದಂತೆ ಮಾಡು	ಸದೆಬಡಿ
ತಲೆ ಓಡದಿರು	ಏನೂ ತೋಚದಿರು
ತಲೆ ನೆಲದತ್ತ ವಾಲು	ಸಂಕೋಚದಿಂದಿರು
ತಲೆ ಮೇಲೆ ಗೂಬೆ ಕೂರಿಸು	ಅಪವಾದ ಹೊರಿಸು
ತಲೆ ಹಾಕು	ಮಧ್ಯೆ ಪ್ರವೇಶಿಸು
ತಾಟಕಿ	ಕೆಟ್ಟ ಹೆಂಗಸು
ತುಂಬು ಹೃದಯ	ಒಳ್ಳೆಯ ಮನಸ್ಸಿನವ
ತುದಿಗಾಲ ಮೇಲೆ ನಿಂತಿರು	ಬಹಳ ಕಾತುರದಿಂದಿರು
ದಾರಿದೀಪ	ಮಾರ್ಗದರ್ಶಿ
ದಿಕ್ಕು ತೋಚದಿರು	ದಾರಿ ಕಾಣದಂತಾಗು
ನಡುನೀರಲ್ಲಿ ಕೈಬಿಡು	ನಂಬಿಸಿ ವಿಶ್ವಾಸಘಾತ ಮಾಡು
ನರಿಯ ಕಕ್ಕೆಕಾಯಿ ವ್ರತ	ಪಾಲಿಸಲಾಗದ ಪ್ರತಿಜ್ಞೆ
ನರಿಯ ಬುದ್ದಿ	ಮೋಸಗಾರಿಕೆ
ನಾಯಿ ಬುದ್ಧಿ	ನೀಚತನ
ನಾಯಿ ಮುಟ್ಟಿದ ಮಡಕೆ	ಅಪವಿತ್ರವಾದದ್ದು
ನಾಯಿ ಮೊಲೆ ಹಾಲು	ನಿಷ್ಟ್ರಯೋಜಕವಾದುದು
ನಾಯಿಪಾಡು	ತುಂಬಾ ಹೀನ ಪರಿಸ್ಥಿತಿ
ನಾಲಗೆ ಉದ್ದಮಾಡು	ಮಿತಿ ಮೀರಿ ಮಾತಾಡು
ನೀರ ಮೇಲಿನ ಗುಳ್ಳೆ	ಶಾಶ್ವತವಲ್ಲದ್ದು, ಕ್ಷಣಿಕ
ನೀರಿನಲ್ಲಿ ಮಾಡಿದ ಹೋಮ-	ವ್ಯರ್ಥ ಕಾರ್ಯ
ನೀರು ಕುಡಿದ ಹಾಗೆ	ಸುಲಭವಾಗಿ
ನುಂಗಿ ನೀರು ಕುಡಿ	ಹಾಳು ಮಾಡು
ನೆತ್ತಿಯ ಪಿತ್ತ ಇಳಿಸು	ಅಹಂಕಾರ ಇಳಿಸು
ನೆಲ ಕಚ್ಚು	ಸೋಲು, ಹತಾಶೆ
ನೆಲಸಮವಾಗು	ಧ್ವಂಸವಾಗು
ಪುಸ್ತಕದ ಬದನೆಕಾಯಿ	ಅನುಭವಕ್ಕೆ ಬಾರದ್ದು
ಪೂಜೆ ಮಾಡು	ತಕ್ಕ ಶಾಸ್ತಿ ಮಾಡು
ಬಗ್ಗುಬಡಿ	ಬಾಯಿ ಮುಚ್ಚಿಸು
ಬಣ್ಣ ಬಯಲು	ಮೋಸ ಹೊರಬೀಳು
ಬಲಿ ಬೀಳು	ತುತ್ತಾಗು
ಬಲಿ ಹಾಕು	ಶಿಕ್ಷಿಸು
ಬಸವನ ಹಿಂದೆ ಬಾಲ	ಎಡೆಬಿಡದ ಸಂಗಾತಿ
ಬಾಯಿ ಬಂಧನ	ಉಪವಾಸ
ಬಾಯಿಬೆಲ್ಲ	ಮರುಳಾಗುವ ಮಾತು
ಬಿಳಿ ಕುದುರೆ ಚಾಕರಿ	ಅತೀವ ಶಿಸ್ತು
ಬಿಳೀ ಮಜ್ಜಿಗೆ	ಹೆಂಡ
ಬೆನ್ನ ಮೇಲೆ ಕೂರು	ಹಿಂಸಿಸು
ಬೆನ್ನ ಹತ್ತು	ಹಿಂಬಾಲಿಸು
ಬೆನ್ನಿನ ಹೊಗೆಯೆಬ್ಬಿಸು	ಚೆನ್ನಾಗಿ ಹೊಡೆ
ಬೆನ್ನುಕಾಯಿ	ಕಾಪಾಡು
ಬೆರಳು ತೋರಿಸಿದರೆ ಹಸ್ತ ನುಂಗು	ಬಹಳ ಚುರುಕಾಗಿರು
ಬೆಳ್ಳಿನಾಲಿಗೆ	ಅನುನಯದ ಮಾತು
ಬೇಳೆಬೇಯು	ಯುಕ್ತಿ ಸಫಲವಾಗು
ಬ್ರಹ್ಮಲಿಪಿ	ಯಾರಿಗೂ ತಿಳಿಯದ ಲಿಪಿ
ಭಾರ ಹಾಕು	ಹೊಣೆಯನ್ನು ಹೊರು
ಭೂಮಿ ತೂಕದವ	ಭೂಮಿಯಂತೆ ಬಹು ಶಾಂತ ಸ್ವಭಾವದವ
ಮಂಗಳಾರತಿ ಎತ್ತು	ಅವಮಾನಪಡಿಸು
ಮಗ್ಗ ನೇಯು	ಚಾಡಿ ಹೇಳು
ಮಣ್ಣುಪಾಲಾಗು	ನಾಶ ಹೊಂದು
ಮಣ್ಣುಪಾಲು ಮಾಡು	ನಾಶ ಮಾಡು
ಮನಸ್ಸನ್ನು ಕಲ್ಲು ಮಾಡಿಕೋ	ಧೈರ್ಯ ತಾಳು
ಮನೆ ತೊಳೆ	ಹಾಳು ಮಾಡು
ಮನೆ ಮುರಿ	ನಾಶ ಮಾಡು
ಮನೆ ಮುಳುಗಿಸಿ	ನಾಶ ಮಾಡು
ಮನೆ ಹೊಕ್ಕ ಮಾರಿ	ಅಪಾಯಕಾರಿ
ಮರ್ಜಿ ಹಿಡಿ	ಅನುಗ್ರಹವನ್ನು ಸಂಪಾದಿಸು
ಮಸ್ಕಾ ಹೊಡೆ	ಪುಸಲಾಯಿಸು
ಮಾತು ಕೊಡು	ವಚನ ಕೊಡು
ಮಾತೆತ್ತು	ಮಾತು ಆರಂಭಿಸು
ಮಾನ ಕಾಯು	ಗೌರವ ಉಳಿಸು
ಮುಂಗೈ ತಿಕ್ಕು	ವಿನಯ ತೋರಿಸು
ಮುಖ ಕಿವುಚು	ಅಸಹ್ಯ ಪಡು
ಮುಖ ಕೆಳಗೆ ಹಾಕುವಾ	ತಲೆ ತಗ್ಗಿಸು
ಮುಖ ಗಂಟು ಹಾಕಿಕೋ	ಸಿಡುಕು
ಮುಖ ದಾಕ್ಷಿಣ್ಯ	ಮುಖ ತೋರಿಸಿದಾಗ ಮಾತ್ರ ತೋರಿಸುವ ದಾಕ್ಷಿಣ್ಯ
ಮುಖಕ್ಕೆ ಮಸಿ ಹಚ್ಚು	ಅವಮಾನಿಸು
ಮುಖಗಂಟಿಕ್ಕು	ಮುಖ ಸಿಂಡರಿಸು
ಮುಖವೀಣೆ	ಮುಖಸ್ತುತಿ ಮಾಡುವವರು
ಮುಟ್ಟಿದೆಲ್ಲ ಹೊನ್ನು	ಒಳ್ಳೆಯದಾಗು
ಸೇಡಿಗೆ ಪ್ರತಿಸೇಡು	ಮುಖ್ಯಿಗೆ ಮುಯ್ಯಿ
ಮೂರು ಕಾಸಿನವ	ಮರ್ಯಾದೆಗೆಟ್ಟವನು
ಮೆಟ್ಟಿ ನಿಲ್ಲು	ನಿಯಂತ್ರಿಸು
ಮೈ ಪಾದರಸವಾಗು	ಚಂಚಲವಾಗು
ಮೈ ಮುಖಕ್ಕೆ ಕೆಸರು ಎರಚಿಕೊ	ಅಸಹ್ಯ ಕೆಲಸ ಮಾಡಿಕೊ
ಮೊಟ್ಟೆ ಕೋಳಿ	ಸೋಮಾರಿ
ಮೊದ್ದುಮಣಿ	ಪೆದ್ದ
ಮೋಡ ಕವಿ	ಮಂಕಾಗು
ಯಮಬಾಧೆ	ತೀವ್ರವಾದ ಹಿಂಸೆ
ರಕ್ತಹೀರು	ಶೋಷಣೆ ಮಾಡು
ರಾಮವಾಕ್ಯ	ತಪ್ಪದ ಮಾತು
ರೆಕ್ಕೆ ಮೂಡು	ಉತ್ಸಾಹ ಹೆಚ್ಚಾಗು
ರೊಟ್ಟಿ ಜಾರಿ ತುಪ್ಪಕ್ಕೆ ಬೀಳು	ಇಷ್ಟಾರ್ಥ ನೆರವೇರು
ವಕ್ರದೃಷ್ಟಿ	ಕೆಟ್ಟ ನೋಟ
ವಾಮನಮೂರ್ತಿ	ಕುಳ್ಳಗಿನ ವ್ಯಕ್ತಿ
ವಿಕೋಪಕ್ಕೆ ಹೋಗು	ಕೈ ಮೀರು
ವಿಷ ಕಕ್ಕು	ಅಸೂಯೆಪಡು
ವೀಳ್ಯ ಕೊಡು	ಆಜ್ಞೆ ಮಾಡು
ಶುದ್ಧ ಮೊದ್ದು	ಮೂರ್ಖ
ಸುಗ್ರೀವಾಜ್ಞೆ	ಕಟ್ಟಪ್ಪಣೆ
ಸೊಪ್ಪು ಹಾಕು	ಲಕ್ಷ್ಯ ನೀಡು
ಹನುಮಂತನ ಬಾಲ	ಮುಗಿಯದ ಕತೆ
ಹಬ್ಬ ಮಾಡು	ಶಿಕ್ಷೆ ನೀಡು
ಹರಟೆ ಕೊಚ್ಚು	ವ್ಯರ್ಥವಾಗಿ ಮಾತನಾಡು
ಹರಿತ ನಾಲಗೆ	ಕಠೋರವಾಗಿ ಮಾತನಾಡುವವ
ಹಲ್ಲುಕಿರಿ	ದೈನ್ಯದಿಂದ ಬೇಡು
ಹಲ್ಲುಮಸೆ	ದ್ವೇಷ ಸಾಧಿಸು
ಹಲ್ಲುಮುರಿ	ಗರ್ವ ಅಡಗಿಸು
ಹಿಗ್ಗಿ ಹಿರೇಕಾಯಿಯಾಗು	ಬಹಳ ಸಂತೋಷಗೊಳ್ಳು
ಹುಬ್ಬುಗಂಟಿಕ್ಕು	ಕೋಪಗೊಳ್ಳು
ಹೃದಯ ವಿದ್ರಾವಕ	ಭಯಂಕರ
ಹೃದಯಹೀನ	ಕಟುಕ
ಹೆತ್ತೊಡಲು	ತಾಯಿಯ ಕರುಳು
ಹೇಳಿದ ಹಾಗೆ ಕುಣಿ.	ವಶವರ್ತಿಯಾಗು
ಹೊಟ್ಟೆ ಕಟ್ಟು	ಮಿತವ್ಯಯ ಮಾಡು
ಹೊಟ್ಟೆಯು ಹುಣ್ಣಾಗುವಷ್ಟು	ಅತಿಶಯ ನಗು
ಹೊತ್ತು ಮುಳುಗು.	ಸಂಜೆಯಾಗು
ಅಜರಾಮರ	ಶಾಶ್ವತ
ಅಜ್ಜಿಕತೆ	ಹಳೆಯ ಕಟ್ಟುಕತೆ
ಅಡ್ಡ ಬೀಳು	ನಮಸ್ಕರಿಸು
ಅಡಿಮೇಲಾಗು	ಹಾಳಾಗು
ಅನ್ನದ ದಾರಿ	ಬದುಕುವ ಮಾರ್ಗ
ಅಮಾವಾಸ್ಯೆಗೊಮ್ಮೆ ಹುಣ್ಣಿಮೆಗೊಮ್ಮೆ	ಅಪರೂಪಕ್ಕೆ ಒಂದು ಸಲ
ಅರ್ಧಚಂದ್ರ ಪ್ರಯೋಗ	ಕುತ್ತಿಗೆ ಹಿಡಿದು ನೂಕು
ಅರೆದು ಕುಡಿ	ಚೆನ್ನಾಗಿ ಅಭ್ಯಾಸ ಮಾಡು
ಅರೆಮನಸ್ಸು	ಪೂರ್ಣ ಒಪ್ಪದಿರು
ಆಟ ನಡೆಯದಿರು	ಪ್ರಭಾವ ಉಂಟಾಗದಿರು
ಆರಡಿ ದೇಹ ಮೂರಡಿ ಮಾಡು	ಕುಗ್ಗು
ಇದಿರು ನೋಡು	ನಿರೀಕ್ಷಿಸು
ಇದಿರು ವಾದಿಸು	ಪ್ರತಿವಾದ ಮಾಡು
ಇಮ್ಮನಸ್ಸು	ಇಬ್ಬಂದಿತನ
ಉಪ್ಪು ಕಾರ ಹಚ್ಚು	ಸ್ವಲ್ಪ ಸೇರಿಸಿ ವರ್ಣಿಸಿ ಹೇಳು
ಉಭಯಸಂಕಟ	ಎರಡರಲ್ಲಿ ಏನನ್ನು ಆರಿಸಿಕೊಳ್ಳಬೇಕೆಂಬ ಚಿಂತೆ
ಉರಿದು ಬೀಳು	ಕೋಪದಿಂದ ರೇಗು
ಉರುಳಾಗು	ಕಷ್ಟಕ್ಕೆ ಸಿಲುಕಿಸು
ಎತ್ತಂಗಡಿಯಾಗು	ವರ್ಗವಾಗು
ಎತ್ತಿ ಹಾಕು	ಲಪಟಾಯಿಸು
ಎತ್ತಿ ಹಿಡಿ	ಅನುಮೋದಿಸು
ಎದೆಯ ಮೇಲಿನ ಭಾರ ಇಳಿ	ಜವಾಬ್ದಾರಿ ಕಡಿಮೆಯಾಗು
ಎದೆಯೊಡೆ	ಬಹುದುಃಖವಾಗು
ಎರಡು ನಾಲಗೆ	ಸಮಯಕ್ಕೆ ತಕ್ಕಂತೆ ಮಾತು ಬದಲಿಸುವ ಸ್ವಭಾವ
ಒಮ್ಮನಸ್ಸು	ಒಂದೇ ಅಭಿಪ್ರಾಯ
ಕಂಕಣಬದ್ಧನಾಗು	ಸಂಕಲ್ಪ ಮಾಡು
ಕಂಠ ಶೋಷಣೆ	ವ್ಯರ್ಥವಾದ ಮಾತು
ಕಡ್ಡಿ ಮುರಿದಂತೆ ಹೇಳು	ಖಂಡಿತವಾಗಿ ಹೇಳು
ಕಣ್ಣಲ್ಲಿ ಕಣ್ಣಿಟ್ಟು ನೋಡಿಕೊಳ್ಳು	ಜೋಪಾನವಾಗಿ ರಕ್ಷಿಸು
ಕಣ್ಣಿಗೆ ಕಟ್ಟು	ಸ್ಪಷ್ಟವಾಗಿ ನೆನಪಿರು
ಕಣ್ಣೀರಿನಲ್ಲಿ ಕೈತೊಳೆ	ಕಷ್ಟಕ್ಕೆ ಗುರಿಯಾಗು
ಕಣ್ಣು ಕೆಂಪಾಗು	ಕೋಪಗೊಳ್ಳು
ಕಣ್ಣು ತಾಗು	(ದೃಷ್ಟಿಯಾಗು
ಕಣ್ಣು ತೆರೆಸು	ಜ್ಞಾನೋದಯ ಉಂಟುಮಾಡು
ಕಣ್ಣುಮುಚ್ಚು	ಮರಣ ಹೊಂದು
ಕಗ್ಗೋಡಿಸು	ಮೇಲುನೋಟಕ್ಕೆ ಪರೀಕ್ಷಿಸು
ಕನಸು ನನಸಾಗು	ಆಶೆ ನೆರವೇರು
ಕಪಾಲಮೋಕ್ಷ ಮಾಡು	ಕೆನ್ನೆಗೆ ಹೊಡೆ
ಕರ ಜೋಡಿಸು	ಕೈಮುಗಿ
ಕರುಳು ಕಿತ್ತು ಬರು	ಬಹಳ ದುಃಖವಾಗು
ಇನ್ನು ಅಲ್ಲಿ ನಿಲ್ಲುವುದು ಸರಿಯಲ್ಲ ಕಾಲು ಕೀಳು	ಹೊರಡು
ಕಾಲು ಕೆರೆ	ಜಗಳಕ್ಕೆ ಮುಂದಾಗು
ಕಾಲು ಚಾಚಿ ಕುಳಿತುಕೊಳ್ಳು	ದುಡಿಯದೆ ಆರಾಮವಾಗಿರು
ಕಿಡಿಕಾರು	ಸಿಟ್ಟಿಗೇಳು
ಕಿವಿಗೊಡು	ಗಮನವಿಟ್ಟು ಕೇಳು
ಕಿವಿ ಹಿಂಡು	ಬುದ್ದಿ ಹೇಳು
ಕಿವಿ ದೂರ	ಸರಿಯಾಗಿ ಕೇಳದಿರು
ಕುಂಟುನೆಪ	ಸಕಾರಣವಲ್ಲದುದು
ಕುಗ್ಗಿ ಹೋಗು	ಕೃಶವಾಗು, ದುಃಖಿತನಾಗು
ಕುತ್ತಿಗೆಗೆ ಕಟ್ಟು	ಬಲವಂತವಾಗಿ ಹೊಣೆ ವಹಿಸು
ಕುತ್ತಿಗೆಯ ಮೇಲೆ ಕುಳಿತುಕೊಳ್ಳು	ಬಲವಂತ ಮಾಡು
ಕೂದಲು ಕೊಂಕದಿರು	ಏನೂ ತೊಂದರೆಯಾಗದಿರು
ಕೂದಲು ನೆಟ್ಟಗೆ ನಿಲ್ಲು	ರೋಮಾಂಚವಾಗ
ಕೈಕಟ್ಟು	ತಡೆ, ಹಿಂದೆ.ನಿಲ್ಲು
ಕೈ ಕಟ್ಟಿ ಕುಳಿತುಕೊಳ್ಳು	ನಿಸ್ಸಹಾಯಕನಾಗು
ಕೈ ಕೈ ಹಿಸುಕಿಕೊಳ್ಳು	ಪೇಚಾಡು
ಕೈಚಾಚು	ನೆರವು ಕೇಳು
ಕೈಚೆಲ್ಲು	ನಿರಾಶನಾಗು
ಕೈ ಜಾರು	ಅಧೀನದಿಂದ ಬಿಟ್ಟು ಹೋಗು
ಕೈ ಬರಿದಾಗು	ಏನೂ ಇಲ್ಲದಿರು
ಕೈ ಬಿಸಿ ಮಾಡು	ಲಂಚ ಕೊಡು
ಕೈ ಮಾಡು	ಹೊಡೆ
ಕೈ ಮೇಲಾಗು	ಗೆಲ್ಲು
ಕೈ ಸುಟ್ಟುಕೊಳ್ಳು	ವ್ಯವಹಾರದಲ್ಲಿ ನಷ್ಟವಾಗು
ಕೊರಳಿಗೆ ಕಟ್ಟು	ಒತ್ತಾಯದಿಂದ ವಹಿಸು
ಕೊಡಲಿ ಪೆಟ್ಟು	ಮೂಲಕ್ಕೆ ಆಘಾತವಾಗು
ಕೋಡು ಮೂಡು	ಗರ್ವಿಸು
ಗಂಟಲು ಹರಿದುಕೋ	ಗಟ್ಟಿಯಾಗಿ ಮಾತನಾಡು
ಗಂಟು ಮೂಟೆ ಕಟ್ಟು	ಊರು ಬಿಟ್ಟು ಹೊರಡು
ಗಜಗಮನ	ನಿಧಾನದ ನಡೆ
ಗಾಯದ ಮೇಲೆ ಬರೆ ಎಳೆ	ಮತ್ತೆ ಮತ್ತೆ ಕಷ್ಟ ಬರುವುದು
ಗಾಳಿ ಹಾಕು	ಪ್ರಚೋದಿಸು
ಗಾಳಿಯಲ್ಲಿ ಗೋಪುರ ಕಟ್ಟು	ಕಲ್ಪನೆ ಮಾಡು
ಗೋತಾ ಹೊಡಿ	ವಿಫಲವಾಗ
ಚುಚ್ಚಿ ಕೊಡು	ಚಾಡಿ ಹೇಳು
ಜುಟ್ಟು ಕೈಗೆ ಕೊಡು	ವಶನಾಗು
ಜೇಬು ತೂತಾಗು	ಹಣವಿಲ್ಲದಿರು
ಟೊಂಕಕಟ್ಟಿ ನಿಲ್ಲು	ಸಿದ್ಧನಾಗಿರು
ಡುಮ್ಮಿ ಹೊಡೆ	ಪರೀಕ್ಷೆಯಲ್ಲಿ ಅನುತ್ತೀರ್ಣನಾಗು
ತಂಪು ಹೊತ್ತಿನಲ್ಲಿ ನೆನೆ	ಕೃತಜ್ಞತೆಯಿಂದ ಸ್ಮರಿಸು
ತಕ್ಕಡಿ ತೂಗು	ಸಮವಾಗಿರು
ತಲೆ ಎತ್ತಿ ತಿರುಗು	ಮರ್ಯ್ಯಾದೆಯಿಂದ ಬದುಕು
ತಲೆಕಾಯು	ರಕ್ಷಿಸು
ತಲೆಗೆ ತಾಗು	ಕಷ್ಟದ ಅರಿವಾಗು
ತಲೆದೋರು	ಕಾಣಿಸಿಕೊಳ್ಳು
ತಲೆಬಾಗು	ವಂದಿಸು, ಗೌರವಿಸು
ತಲೆ ಮೇಲೆ ಕೈ ಹೊರು	ಕಂಗಾಲಾಗು
ತಲೆಯ ಮೇಲೆ ಹಾಕು	ಹೊಣೆ ಹೊರೆಸು
ತಲೆಯೆತ್ತು	ಉಂಟಾಗು
ತಾಳ ಮೇಳ	ಹೊಂದಾಣಿಕೆ
ತಾಳಕ್ಕೆ ಹೆಜ್ಜೆ ಹಾಕು	ಹೇಳಿದಂತೆ ಕೇಳು
ತಿಲಾಂಜಲಿ ಕೊಡು	ಆಶೆ ಬಿಡು
ತುಟಿ ಪಿಟಕ್ಕೆನ್ನು	ಏನಾದರೂ ಮಾತನಾಡು
ತೂಕದ ಮನುಷ್ಯ	ಗೌರವಾನ್ವಿತ ವ್ಯಕ್ತಿ
ತೃಣಕ್ಕೆ ಸಮಾನ	ಅಲ್ಪ ವಸ್ತು
ತೆರೆ ಬೀಳು	ಮುಗಿ
ದಡ ಕಾಣಿಸು	ಪಾರು ಮಾಡಿಸು
ದಂಡಯಾತ್ರೆ ಮಾಡು	ಮತ್ತೆ ಮತ್ತೆ ಫೇಲಾಗು
ದಮ್ಮು ಕಟ್ಟು	ಉಸಿರು ಬಿಗಿಹಿಡಿ
ದಯಮಾಡಿಸು	ಆಗಮಿಸು / ಹೊರಡು
ದಾರಿಯಿಲ್ಲದಿರು	ನಿರುಪಾಯವಾಗಿ
ದಾರಿ ಹಿಡಿ	ಹೊರಡು
ದಾರಿದೀಪವಾಗು	ಮಾರ್ಗದರ್ಶಕನಾಗು
ದಿಕ್ಕಿಲ್ಲದಿರು	ನಿರ್ಗತಿಕನಾಗಿರು
ದಿಕ್ಕಾಪಾಲಾಗು	ಚೆದುರಿಹೋಗು
ದಿನ ದೂಡು	ಕಾಲ ಕಳೆ
ದೂರದೃಷ್ಟಿ	ಮುಂದಾಲೋಚನೆ
ದೇಶಾಂತರ ಹೋಗು	ಗತಿಯಿಲ್ಲದೆ ಅಲೆದಾಡು
ದೈವಾಧೀನನಾಗು	ಸಾಯು
ಧಾರೆಯೆರೆ	ಮದುವೆ ಮಾಡು
ಧೂಳೀಪಟವಾಗು	ನಾಶವಾಗು
ನಡು ನೀರಿನಲ್ಲಿ ಕೈಬಿಡು	ಅರ್ಧದಲ್ಲಿ ತ್ಯಜಿಸು
ನಾಂದಿಹಾಡು	ಪ್ರಾರಂಭಿಸು
ನಾಚಿ ನೀರಾಗು	ಅತಿಯಾಗಿ ನಾಚಿಕೊಳ್ಳು
ನಾಲಿಗೆ ಉದ್ದವಾಗು	ಹದ್ದುಮೀರಿ ಮಾತನಾಡು
ನಿರಂಕುಶ	ಹತೋಟಿಯಿಲ್ಲದ
ನಿರಕ್ಷರಕುಕ್ಷಿ	ಅನಕ್ಷರಸ್ಥ
ನಿರ್ನಾಮವಾಗು	ನಾಶಹೊಂದು
ನೀರಿಗೆ ಹಾಕು	ವ್ಯರ್ಥ ಮಾಡು
ನೀರಿನಲ್ಲಿ ಹೋಮ ಮಾಡು	ವ್ಯರ್ಥ ಪ್ರಯತ್ನ
ನೀರಿನ ಮೇಲಣ ಗುಳ್ಳೆ	ಕ್ಷಣಿಕ
ನೀರೆರೆ	ಪ್ರೋತ್ಸಾಹಿಸು
ನುಣ್ಣಗೆ ಮಾಡು	ಎಲ್ಲವನ್ನೂ ಹಾಳುಮಾಡು
ನೆಟ್ಟಗೆ	ಬೇರೆಕಡೆ ಗಮನಹರಿಸದೆ
ನೆಟ್ಟಗೆ ಮಾಡು	ಸರಿಪಡಿಸು
ನೆಲದ ಮೇಲೆ ನಿಲ್ಲದಿರು	ಜಂಬ ತೋರು
ನೊಗ ಇಳಿಸು	ಹೊಣೆಗಾರಿಕೆಯಿಂದ ಬಿಡುಗಡೆ ಹೊಂದು
ಪಟ್ಟುಹಿಡಿ	ಹಟ ಸಾಧಿಸು
ಪಡಿಯಚ್ಚು	ಯಥಾರೂಪ
ಪಥ್ಯವಾಗು	ಹಿತವಾಗು
ಪರಾಕು ಹೇಳು	ಹೊಗಳು
ಪಲಾಯನಸೂತ್ರ ಪಠಿಸು	ಓಡಿಹೋಗು
ಪಳಗಿದ ಕೈ	ಅನುಭವಸ್ಥೆ
ಪ್ರಪಂಚಕ್ಕೆ ಕಾಲಿಡು	ಹುಟ್ಟು / ಜೀವನಮಾರ್ಗದಲ್ಲಿ ಕ್ರಮಿಸು
ಪಾಡುಪಡು	ತೊಂದರೆ ಅನುಭವಿಸು
ಪಾತಾಳಕ್ಕಿಳಿದು ಹೋಗು	ಕುಗ್ಗಿಹೋಗು
ಪಾತಾಳಕ್ಕೆ ಮೆಟ್ಟು	ಅವನತಿಗೆ ತಳ್ಳು
ಪಾದಸೇವೆ ಮಾಡು	ಭಕ್ತಿಪೂರ್ವಕ ಉಪಚಾರ ಮಾಡು
ಪಾರುಗಾಣಿಸು	ಮುಗಿಸು/ಪರಿಹರಿಸು
ಪಾರುಪತ್ಯ ಮಾಡು	ಅಧಿಕಾರ ಚಲಾಯಿಸು
ಪಾಲಿಗೆ ಬಂದದ್ದು ಪಂಚಾಮೃತವೆಂದು ಭಾವಿಸು	ಇದ್ದುದರಲ್ಲಿ ತೃಪ್ತಿಪಟ್ಟುಕೋ
ಪ್ರಾಣ ಕೊಡು	ಸೇವೆಗೆ ಸಿದ್ಧನಾಗಿರು
ಪ್ರಾಣ ಬರು	ಚೈತನ್ಯವುಂಟಾಗು
ಪ್ರಾಣ ಬಿಡು	ಅತಿಯಾಗಿ ಇಷ್ಟಪಡು
ಪ್ರಾಣವಿಡು	ಪ್ರೀತಿಸು
ಪ್ರಾಣವನ್ನು ಕೈಯಲ್ಲಿ ಹಿಡಿ	ಅತಿಯಾಗಿ ಹೆದರು
ಪ್ರಾಣವನ್ನು ಪಣವಾಗಿಡು	ಎಂತಹ ವಿಪತ್ತಿಗೂ ಸಿದ್ಧನಾಗಿರು
ಪಿಷ್ಟಪೇಷಣ	ಹೇಳಿದ್ದನ್ನೇ ಹೇಳು
ಪುಂಖಾನುಪುಂಖ	ಒಂದರ ಹಿಂದೊಂದು
ಪುಟಕ್ಕಿಟ್ಟ ಚಿನ್ನ	ಉತ್ತಮ ನಡತೆಯುಳ್ಳವ
ಪೆಟ್ಟು ತಿನ್ನು	ನಷ್ಟ ಅನುಭವಿಸು
ಬಗಲಿಗೆ ಹಾಕಿಕೊಳ್ಳು	ವಶಮಾಡಿಕೊಳ್ಳು
ಬಣ್ಣಕಟ್ಟು	ವರ್ಣಿಸಿ ಹೇಳು
ಬಣ್ಣ ಹಚ್ಚು	ವರ್ಣಿಸಿ ಹೇಳು
ಬಣ್ಣದ ಚಿಟ್ಟೆ	ಸೊಗಸುಗಾತಿ ಹೆಣ್ಣು
ಬಣ್ಣದ ಬದುಕು	ಮೇಲುನೋಟಕ್ಕೆ ಚೆನ್ನಾಗಿ ಕಾಣುವ ಜೀವನ
ಬದಿಗೊತ್ತು	ಅಲಕ್ಷ ಮಾಡು
ಬದ್ಧಕಂಕಣ	ಸಂಕಲ್ಪ ಮಾಡು
ಬಯಲಿಗೆಳೆ	ನಿಜಸಂಗತಿಯನ್ನು ಪ್ರಕಟಪಡಿಸು
ಬರಿಗೈಯಿಂದ ಬರು	ಕೆಲಸವಾಗದೆ ಹಿಂತಿರುಗು
ಬಲಗೈ ಬಂಟ	ನಂಬುಗೆಯ ಸೇವಕ
ಬಲಭುಜ	ಆಪ್ತ ಸಹಾಯಕ
ಬಲವಂತದ ಮಾಘಸ್ನಾನ	ಒತ್ತಾಯದಿಂದ ಮಾಡಬೇಕಾದ ಕೆಲಸ
ಬಾಗಿಲು ತೆರೆ	ಸ್ವಾಗತಿಸು
ಬಾಗಿಲಿಗೆ ಎಡತಾಕು	ಭೇಟಿಯಾಗಲು ಪದೇಪದೇ ಯತ್ನಿಸು
ಬಾಯಳಿ	ಮಾತಿಲ್ಲದಿರು
ಬಾಯುಪಚಾರ	ಬರೀ ಮಾತಿನ ಸತ್ಕಾರ
ಬಾಯಿ ಬಡಿದುಕೊಳ್ಳು	ಗೋಳಾಡು
ಬಾಯಿ ಬರು	ಮಾತು ಹೊರಡು
ಬಾಯಿ ಮುಚ್ಚು	ಸುಮ್ಮನಿರು
ಬಾಯಿಮಾತು	ಕೇವಲ ಹೇಳಿಕೆ
ಬಾಲ ಆಡಿಸು	ವಿಧೇಯತೆ ತೋರು
ಬಾಲ ಮುದುಡಿಕೊಂಡಿರು	ಹೆದರಿಕೊಂಡು ಸುಮ್ಮನಿರು
ಬಾಳಿನ ಮುಸ್ಸಂಜೆ	ಮುಪ್ಪು
ಬಿಕೋ ಎನ್ನು	ಖಾಲಿಯೆನಿಸು
ಬಿಡಿಸಲಾಗದ ಒಗಟು	ಅರ್ಥವಾಗದ ಸಮಸ್ಯೆ
ಬಿಸಿ ಮಾಡು	ಚುರುಕು ಮುಟ್ಟಿಸು
ಬಿಸಿ ತಾಗು	ತೊಂದರೆಯ ಅರಿವಾಗು
ಬಿಸಿಬಿಸಿ ಸುದ್ದಿ	ಇತ್ತೀಚಿನ ಸುದ್ದಿ
ಬೀದಿಗೆ ಬೀಳು	ಅನಾಥ ಮಗ
ಬೀಸುವ ದೊಣ್ಣೆಯಿಂದ ತಪ್ಪಿಸಿಕೊಳ್ಳು	ಅಪಾಯದಿಂದ ಪಾರಾಗು
ಬುಟ್ಟಿಗೆ ಹಾಕಿಕೊಳ್ಳು	ವಶಪಡಿಸಿಕೊಳ್ಳು
ಬುಡಕ್ಕೆ ಕೊಡಲಿಯಿಡು	ನಾಶಮಾಡು
ಬುಡಮೇಲಾಗು	ವ್ಯತಿರಿಕ್ತ ಪರಿಣಾಮವಾಗು
ಬುದ್ದಿ ಕಲಿಸು	ಮಾಡಿದ ತಪ್ಪಿಗೆ ಪ್ರತೀಕಾರ ಮಾಡು
ಬುರುಡೆಬಿಡು	ಸುಳ್ಳು ಹೇಳು
ಬೂದಿ ಮುಚ್ಚಿದ ಕೆಂಡ	ಕಾಣದಿರುವ ನಿಜರೂಪ
ಬೆಂಬಿಡದೆ	ಜೊತೆ ಬಿಡದೆ
ಬೆಂಬತ್ತು	ಹಿಂಬಾಲಿಸಿ ಹೋಗು
ಈ ಬೆಟ್ಟಕ್ಕೆ ಕಲ್ಲು ಹೊರು	ಪ್ರಯೋಜನವಿಲ್ಲದ ಕೆಲಸ
ಬೆತ್ತದ ರುಚಿ ತೋರಿಸು	ಲಾಠಿ ಪ್ರಹಾರ ಮಾಡು
ಬೆದರುಬೊಂಬೆ	ಸತ್ಯಹೀನ ವ್ಯಕ್ತಿ
ಬೆನ್ನಟ್ಟು	ಹಿಡಿಯಲು ಹಿಂಬಾಲಿಸಿ ಹೋಗು
ಬೆನ್ನ ಹಿಂದೆ	ತನಗೆ ತಿಳಿಯದಂತೆ
ಬೆನ್ನಿಗೆ ಇರಿ	ವಿಶ್ವಾಸದ್ರೋಹ
ಬೆನ್ನಿಗೆ ಎಣ್ಣೆ ಸವರಿಕೊಳ್ಳು	ಏಟು ತಿನ್ನಲು ಸಿದ್ಧನಾಗು
ಬೆನ್ನಿಗೆ ಕಟ್ಟಿಕೋ	ಜೊತೆಗೆ ಸೇರಿಸಿಕೊಳ್ಳು
ಬೆನ್ನಿಗೆ ಬೀಳು	ಒಡಹುಟ್ಟು
ಬೆನ್ನು ಬಾಗು	ಶ್ರಮಪಟ್ಟು ದುಡಿ
ಬೆನ್ನುಬೆನ್ನಿಗೆ	ಮತ್ತೆ ಮತ್ತೆ
ಬೆನ್ನುಮೂಳೆಯಿಲ್ಲದಿರು	ಧೈರ್ಯವಿಲ್ಲದಿರುವ
ಬೆರಳೆಣಿಕೆಯಷ್ಟು	ಅತಿ ಕಡಿಮೆ
ಬೆಳಗು	ಹೆಸರುವಾಸಿಯಾಗು
ಬೆಳಕು ಕಾಣು	ಪ್ರಕಟವಾಗು
ಬೆಳ್ಳಿ ಮೂಡು	ಬೆಳಗಾಗು
ಬೇರು ಹುಡುಕು	ಮೂಲವನ್ನು ಶೋಧಿಸು
ಬೇರು ಕೀಳು	ಮೂಲವೇ ಇಲ್ಲದಾಗು
ಬೇರುಸಹಿತ ಕೀಳು	ಸರ್ವನಾಶ ಮಾಡು
ಬೇಲಿ ಹಾಕು	ಆವರಣ ನಿರ್ಮಿಸಿಕೊಳ್ಳು
ಬೇಲಿಯೇ ಮೆದ್ದಹಾಗೆ	ರಕ್ಷಕನೇ ನಾಶ ಮಾಡು
ಭಟ್ಟಿ ಇಳಿಸು	ಯಥಾವತ್ತಾಗಿ ನಿರೂಪಿಸು
ಭಾಷೆ ತಪ್ಪು	ಕೊಟ್ಟ ಮಾತಿನಂತೆ ನಡೆಯದಿರು
ಭುಜಕ್ಕೆ ಭುಜ ಕೊಡು	ಸಹಕರಿಸು
ಭೂಮಿಗೆ ಭಾರವಾಗಿರು	ನಿಷ್ಟ್ರಯೋಜಕನಾಗಿರು
ಭೂಮಿಗೆ ಬರು	ಹುಟ್ಟು
ಮಂಗ ಮಾಯ	ಇದ್ದಕ್ಕಿದಂತೆ ಕಾಣದಾಗು
ಮಂತ್ರಹಾಕು	ಬುದ್ದಿ ತಿರುಗಿಸು
ಮಕ್ಕಿ ಕಾ ಮಕ್ಕಿ	ನಕಲುಪ್ರತಿ
ಮಗ್ಗಲು ಮುರಿ	ಚೆನ್ನಾಗಿ ಹೊಡೆ
ಮಡಿಲಲ್ಲಿ ಬೀಳು	ಆಶ್ರಯ ಪಡೆ
ಮಡುಗಟ್ಟು	ತುಂಬಿರು
ಮಣಿಯು	ಒಪ್ಪಿಕೊಳ್ಳು
ಮಣ್ಣಾಂಗಟ್ಟಿ	ಕನಿಷ್ಠ ವಸ್ತು
ಮಣ್ಣಿನ ಮಗ	ರೈತ
ಮಣ್ಣಿನ ವಾಸನೆ	ದೇಶ್ಯ ಗುಣ
ಮಣ್ಣು ತಿನ್ನು	ಹಾಳಾಗು
ಮಣ್ಣುಮುಕ್ಕಿಸು	ಸೋಲಿಸು
ಮಣ್ಣು ಹೊರು	ಶ್ರಮಪಡು
ಮಣ್ಣೆರಚು	ಮೋಸಮಾಡು
ಮಣೆಹಾಕು	ಉಪಚಾರ ಮಾಡು
ಮದವೇರು	ಅಹಂಕಾರ ಹೆಚ್ಚು
ಮದವಿಳಿ	ಅಹಂಕಾರ ತಗ್ಗು
ಮದುವೆ ಮಾಡು	ಶಿಕ್ಷಿಸು
ಮದ್ದು	ಪರಿಹಾರ
ಮನಸ್ಸು ಎಳೆ	ಆಕರ್ಷಿತವಾಗು
ಮನಸ್ಸು ಕಲ್ಲಾಗು	ಭಾವನೆಗೆ ಸ್ಪಂದಿಸದಿರು
ಮನಸ್ಸು ಕೆಡು	ಅಸಮಾಧಾನವಾಗು
ಮನಸ್ಸು ಗಟ್ಟಿಮಾಡು	ನಿಶ್ಚಯಿಸು
ಮನಸ್ಸು ಮುದುಡು	ಕುಗ್ಗು
ಮನಸ್ಸು ಹಗುರಾಗು	ದುಃಖ ಕಡಿಮೆಯಾಗು
ಮನಸ್ಸು ಹಾತೊರೆ	ಹಂಬಲಿಸು
ಮನಸ್ಸು ಹುಳಿಯಾಗು	ಅಸಮಾಧಾನವಾಗು
ಮನಸ್ಸಿನಲ್ಲಿ ಮಂಡಿಗೆ ತಿನ್ನು	ಸಿಗದುದಕ್ಕೆ ಆಶೆಪಡು
ಮನದಣಿಯೆ	ಮನಸ್ಸಿಗೆ ತೃಪ್ತಿಯಾಗುವಂತೆ
ಮನಸೋಲು	ಆಕರ್ಷಿತವಾಗು
ಮನೆಮಾಡು	ನೆಲೆಸು
ಮರುಳಾಗು	ಆಕರ್ಷಿತನಾಗು
ಮಾತಿಗೆ ತಪ್ಪು	ವಚನವನ್ನು ಮೀರು
ಮಾತು ತೆಗೆದುಹಾಕು	ಕಡೆಗಣಿಸು
ಮಾತು ನಡೆಸು	ಮಾತಿನಂತೆ ನಡೆದುಕೊಳ್ಳು
ಮಾತು ಬರು	ವಿಷಯ ಪ್ರಸ್ತಾಪವಾಗು
ಮಾತು ಮೀರು	ಹೇಳಿದಂತೆ ಕೇಳದಿರು
ಮಾತಿಗೆ ಮೀರಿದುದು	ವರ್ಣಿಸಲಾಗದುದು
ಮಾತಿನ ಮೇಲೆ	ವಿಶ್ವಾಸದ ಮೇರೆಗೆ
ಮನೆಮಾತಾಗು	ಜನರಿಗೆಲ್ಲ ಗೊತ್ತಾಗು
ಮಾರಣಹೋಮ	ಸಂಹಾರ ಮಾಡು
ಮಾರಾಮಾರಿ	ಹೊಡೆದಾಟ
ಮಾರುಹೋಗು	ಆಕರ್ಷಿತನಾಗು
ಮೀನಮೇಷ ಎಣಿಸು	ಹಿಂದೆಮುಂದೆ ನೋಡು
ಮೀಸಲು	ಅರ್ಪಿತವಾಗು
ಮೀಸಲಿಡು	
ಮೀಸೆ ಬರು	ಪ್ರಾಯಕ್ಕೆ ಬರು
ಮೀಸೆ ಬೆಳ್ಳಗಾಗು	ಮುದುಕನಾಗು
ಮುಕ್ತಕಂಠ	ತುಂಬುಮನಸ್ಸಿನಿಂದ
ಮುಖ ಇಟ್ಟುಕೊಳ್ಳು	ಮಾನವಾಗಿರು
ಮುಖ ಇರು	ಮರ್ಯಾದೆಯಿಂದಿರು
ಮುಖ ಊರಗಲವಾಗು	ಸಂತೋಷದಿಂದ ಹಿಗ್ಗು
ಮುಖ ಎತ್ತಿ ತಿರುಗು	ಮರ್ಯಾದೆಯಿಂದ ಬದುಕು
ಮುಖ ಕಪ್ಪಿಡು	ಅಪಮಾನವಾಗು
ಮುಖ ಕೆಡಿಸಿಕೊಳ್ಳು	ಅಸಮಾಧಾನಪಡು
ಮುಖ ಕೊಟ್ಟು ಮಾತಾಡು	ಧೈರ್ಯದಿಂದ ವರ್ತಿಸು
ಮುಖ ತಗ್ಗಿಸು	ಅಪಮಾನವಾಗು
ಮುಖ ತಿರುಗಿಸು	ತಿರಸ್ಕಾರ ಮಾಡು
ಮುಖ ತೋರಿಸು	ಕಾಣಿಸಿಕೊಳ್ಳು
ಮುಖ ಬಾಡು	ಸಪ್ಪಗಾಗು
ಮುಖ ಭಂಗವಾಗು	ಅಪಮಾನವಾಗು
ಮುಖ ಮರೆಸಿಕೊಳ್ಳು	ಕಾಣಿಸಿಕೊಳ್ಳದಿರು
ಮುಖ ಮಾಡು	ದೃಷ್ಟಿಹರಿಸು
ಮುಖ ಮುಖ ನೋಡು	ಏನೂ ತಿಳಿಯದಂತಿರು
ಮುಖ ಮುಚ್ಚಿಕೊಳ್ಳು	ನಾಚಿಕೆಪಡು
ಮುಖ ಸಣ್ಣದಾಗು	ಅಸಮಾಧಾನವಾಗು
ಮುಖ ಹಾಕು	ಗಮನಹರಿಸು
ಮುಖಕ್ಕೆ ಮಂಗಳಾರತಿಯಾಗು	ಅಪಮಾನವಾಗು
ಮುಖಕ್ಕೆ ಮರುಳಾಗು	ರೂಪಕ್ಕೆ ಆಕರ್ಷಿತನಾಗು
ಮುಖದ ಮೇಲೆ ಎಸೆ	ತಿರಸ್ಕಾರದಿಂದ ಕೊಡು
ಮುಖ ನೋಡಿ ಮಣೆಹಾಕು	ಪ್ರತ್ಯೇಕ ಮನ್ನಣೆ ಕೊಡು
ಮುಖವಾಡ ಧರಿಸು	ಸೋಗು ಹಾಕು
ಮುಗಿಲ ಮಲ್ಲಿಗೆ	ಸಿಗದಿರುವ ವಸ್ತು
ಮುಟ್ಟಿ ನೋಡಿಕೊಳ್ಳು	ಪರಿಣಾಮ ನೆನಪಿನಲ್ಲಿ ಉಳಿ
ಮುಟ್ಟಿದ್ದೆಲ್ಲ ಬಂಗಾರವಾಗು	ಯಶಸ್ವಿಯಾಗು
ಮುಟ್ಟಿಸು	ತಲುಪಿಸು
ಮುಡುಪುಕಟ್ಟು	ಮೀಸಲಿಡು
ಮುದ್ರೆಯೊತ್ತು	ಅಂಗೀಕರಿಸು
ಮುಂದಕ್ಕೆ ತರು	ಅಭಿವೃದ್ಧಿಗೆ ತರು
ಮುಂದಕ್ಕೆ ಹಾಕು	ಮುಂದಿನ ಸಮಯವನ್ನು ಗೊತ್ತುಪಡಿಸು
ಮುಂದಾಗು	ತೊಡಗು
ಮುಂದಿಡು	ಎದುರಿಗೆ ಇರಿಸು
ಮುಂದುಗಾಣು	ಮುಂದಿನ ಆಲೋಚನೆ ಮಾಡು
ಮುಂದುಗೆಡು	ಮುಂದಿನ ಕರ್ತವ್ಯದ ಬಗೆಗೆ ಗೊತ್ತಾಗದಿರು
ಮುಂದೂಡು	ಕೆಲಸವನ್ನು ಬೇರೆ ಸಮಯಕ್ಕೆ ಗೊತ್ತುಪಡಿಸು
ಮುನ್ನುಡಿ	ಪ್ರಾರಂಭ
ಮುಪ್ಪುರಿಗೊಳ್ಳು	ದೃಢವಾಗಿ ಹೊಂದು
ಮುಖ್ಯ ತೀರಿಸು	ಸೇಡು ತೀರಿಸು
ಮುಷ್ಟಿಯಲ್ಲಿಟ್ಟುಕೊಳ್ಳು	ಹಿಡಿತದಲ್ಲಿರಿ
ಮುಸುರೆ ಕೈಲಿ ಕಾಗೆ ಓಡಿಸದಿರು	ಜಿಪುಣನಾಗಿರು
ಮುಳ್ಳು	ಅಡಚಣೆ / ಕಂಟಕ
ಮುಳ್ಳನ್ನು ಕಿತ್ತುಹಾಕು	ಅಡಚಣೆಯನ್ನು ನಿವಾರಿಸು
ಮುಳ್ಳಿನ ಮೇಲೆ ಕೂತ ಹಾಗಿರು	ಬಹಳ ಕಷ್ಟದಿಂದ ಸಹಿಸು
ಮುಳ್ಳಿಂದಲೇ ಮುಳ್ಳನ್ನು ತೆಗೆ	ಶತ್ರುವಿಂದಲೇ ಶತ್ರುವನ್ನು ನಿವಾರಿಸು
ಮೂಗ ಕಂಡ ಕನಸು	ತಿಳಿದರೂ ವಿವರಿಸಲಾಗದ್ದು
ಮೂಗು ಕೊಯ್ಯು	ಸರಿಪಡಿಸಲಾಗದ ತಪ್ಪು
ಮೂಗುತೂರಿಸು	ಮಧ್ಯ ಪ್ರವೇಶಿಸು
ಮೂಗುದಾರ ಹಾಕು	ಹತೋಟಿಯಲ್ಲಿಡು
ಮೂಗು ಮುಕ್ಕಾಗು	ಗೌರವ ಕಡಿಮೆಯಾಗು
ಮೂಗು ಮುರಿ	ತಿರಸ್ಕಾರ ತೋರು
ಮೂಗಿಗೆ ಕವಡೆ ಕಟ್ಟಿಕೊಳ್ಳು	ಕಷ್ಟಪಟ್ಟು ದುಡಿ
ಮೂಗಿಗೆ ತುಪ್ಪ ಸವರು	ಆಸೆ ತೋರಿಸು
ಮೂಗಿನ ತುದಿ ಕೆಂಪಾಗು	ಸಿಟ್ಟಾಗು
ಮೂಗಿನ ನೇರಕ್ಕೆ ಮಾತನಾಡು	ತನ್ನ ಧೋರಣೆಯನ್ನೇ ಬಲವಾಗಿ ಪ್ರತಿಪಾದಿಸು
ಮೂಗಿನ ತುದಿಯಲ್ಲಿ ಕೋಪವಿರು	ಕೂಡಲೇ ಸಿಟ್ಟಿಗೇಳು
ಮೂಲೆಗುಂಪು ಮಾಡು	ದೂರೀಕರಿಸು
ಮೂಲೆಗೊತ್ತು	ಅಲಕ್ಷ್ಯ ಮಾಡು
ಮೂಲೋಚ್ಚಾಟನೆ ಮಾಡು	ಸರ್ವನಾಶಮಾಡು
ಮೂಸುವವರಿಲ್ಲದಿರು	ಬೇಡಿಕೆಯಿಲ್ಲದಿರು
ಮೃಗಜಲ	ಫಲಿಸದ ಆಸೆ
ಮೃದು ಹೃದಯ	ಭಾವನೆಗೆ ಸ್ಪಂದಿಸುವ ಸ್ವಭಾವ
ಮೆಟ್ಟಲು ತುಳಿ	ಪ್ರವೇಶಿಸು
ಮೆಟ್ಟಲು ಹತ್ತು	ಅನುಭವ ಪಡೆ
ಮೆಲುಕು ಹಾಕು	ನೆನಪುಗಳನ್ನು ಸ್ಮರಿಸು
ಮೇಣದ ಬೊಂಬೆ	ಮೃದುಸ್ವಭಾವದ ವ್ಯಕ್ತಿ
ಮೇಲುಪಂಕ್ತಿ ಹಾಕು	ಆದರ್ಶವಾಗು
ಮೇಲುಸಿರು	ಉಬ್ಬಸ
ಮೇಲೆತ್ತು	ಉದ್ಧರಿಸು
ಮೇಲೆ ನೋಡುತ್ತ ಕುಳಿತುಕೊಳ್ಳು	ಚಿಂತಾಕ್ರಾಂತನಾಗು
ಮೇಲೆ ಕೆಳಗೆ ನೋಡು	ಏನು ಮಾಡುವುದೆಂದು ತಿಳಿಯದಿರು
ಮೇಲಕ್ಕೆ ಬರು	ಏಳಿಗೆ ಹೊಂದು
ಮೇಳವಿಲ್ಲದಿರು	ಹೊಂದಾಣಿಕೆಯಿಲ್ಲದಿರು
ಮೈಯಳಿ	ಸೊರಗು
ಮೈಯರಿ	ಪ್ರಜ್ಞೆ ಬರು
ಮೈ ಉರಿ	ಸಂಕಟ
ಮೈ ಉಬ್ಬು	ಉತ್ಸಾಹಗೊಳ್ಳು
ಮೈ ಕೆಡು	ಆರೋಗ್ಯ ಕೆಡು
ಮೈಗೂಡು	ಸೇರಿಕೊಂಡಿರು
ಮೈ ಚಳಿ ಬಿಡು	ಸಂಕೋಚವನ್ನು ತ್ಯಜಿಸು
ಮೈ ಚೆನ್ನಾಗಿಲ್ಲದಿರು	ಅನಾರೋಗ್ಯವಾಗಿರು
ಮೈ ಚಾಚು	ಮಲಗು
ಮೈಚೆಲ್ಲು	ಆಲಸ್ಯದಿಂದ ಮಲಗು
ಮೈದೋರು	ಕಾಣಿಸಿಕೊಳ್ಳು
ಮೈ ತೇಯು	ಕಷ್ಟಪಡು
ಮೈದಡವು	ಪ್ರೀತಿ ತೋರು
ಮೈ ಬಗ್ಗು	ಶ್ರಮಪಡು
ಮೈ ಬಗ್ಗದಿರು	ಕಷ್ಟಪಡದಿರು
ಮೈ ಬರು	ದಪ್ಪಗಾಗು
ಮೈಬಿಸಿಯಾಗು	ಜ್ವರ ಬರು
ಮೈಮುರಿ	ಶ್ರಮಪಡು
ಮೈಯೆಲ್ಲ ಕಣ್ಣಾಗಿರು	ಎಚ್ಚರದಿಂದ ನೋಡು
ಮೈಯೆಲ್ಲ ಕಿವಿಯಾಗಿರು	ಜಾಗೃತನಾಗಿರು
ಮೈಗಳ್ಳತನ	ಸೋಮಾರಿತನ
ಮೊದಲ ಮೆಟ್ಟಲು	ಪ್ರಾರಂಭ
ಮೊಳಕೆಯಲ್ಲಿಯೇ ಚಿವುಟು	ಪ್ರಾರಂಭದಲ್ಲೇ ನಿವಾರಿಸು
ಮೋಕ್ಷ ಕಾದಿರು	ಶಿಕ್ಷೆಯನ್ನು ನಿರೀಕ್ಷಿಸು
ಯದ್ವಾ ತದ್ವಾ	ಮನಸ್ಸಿಗೆ ಬಂದಂತೆ
ಯಮಸದನಕ್ಕೆ ಅಟ್ಟು	ಸಂಹಾರ ಮಾಡು
. ಯಮಸಾಹಸ	ಬಲು ಕಷ್ಟ
ಯಾದವೀ ಕಲಹ	ಆಂತರಿಕ ಜಗಳ
ರಂಗೋಲೆ ಕೆಳಗೆ ತೂರು	ಬುದ್ಧಿವಂತಿಕೆ ತೋರು
ರಕ್ತ ಕುದಿ	ಸಿಟ್ಟೇರು
ರಕ್ತ ಸಂಬಂಧ	ಸೋದರ ಸಂಬಂಧ
ರಥ ಸಾಗಿಸು	ಜೀವನ ಸಾಗಿಸು
ರಾಜ್ಯಭಾರ ನಡೆಸು	ಆಡಳಿತ ನಡೆಸು
ರಾಜಾರೋಷವಾಗಿ	ಅಂಜಿಕೆಯಿಲ್ಲದೆ
ರಾತ್ರಿ ಹಗಲು	ಇಡೀ ದಿನ
ರಾಮಾಯಣ	ದೊಡ್ಡ ಘಟನೆ
ರಾವು ಬಡಿ	ಗ್ರಹದ ಪೀಡೆಗೆ ಗುರಿಯಾಗು
ರೆಕ್ಕೆ ಪುಕ್ಕ ಬರು	ಶಕ್ತಿ ಮೂಡು
ರೆಪ್ಪೆ ಹೊಡೆಯುವಷ್ಟರಲ್ಲಿ	ಆ ಕ್ಷಣದಲ್ಲಿ
ರೈಲು ಬಿಡು	ಸುಳ್ಳು ಹೇಳು
`ರೊಟ್ಟಿ ಜಾರಿ ತುಪ್ಪಕ್ಕೆ ಬೀಳು	ಆಸೆ ನೆರವೇರು
ರೋಗ	ಕೆಟ್ಟ ಅಭ್ಯಾಸ
ರೋಮ ನೆಟ್ಟಗೆ ನಿಲ್ಲು	ಮೈ ನವಿರೇಳು
ಲಂಗು ಲಗಾಮಿಲ್ಲದಿರು	ಹತೋಟಿಯಿಲ್ಲದಿರು
ಲಕ್ಷ್ಮಿ ತಾಂಡವವಾಡು	ಸಂಪತ್ತು ತುಂಬಿರು
ಲೆಕ್ಕವಿಲ್ಲದಷ್ಟು	ಅನೇಕ
ರಾಜೇಗೌಡರ ಲೆಕ್ಕಾಚಾರ ತೀರಿಸು	ಋಣ ಸಂದಾಯಮಾಡು
ಲೋಕ ಕಾಣು	ಅನುಭವ ಹೊಂದು
ವಕ್ರ ದೃಷ್ಟಿ	ಕೆಟ್ಟ ಆಲೋಚನೆಯಿಂದ ಗಮನಿಸು
ವಕ್ರ ಬುದ್ಧಿ	ಕೆಟ್ಟದನ್ನು ಹುಡುಕುವ ಸ್ವಭಾವ
ವಜ್ರಸು	ಬಯಸದೆ ಆಗಮಿಸು
ವಜ್ರದೇಹ	ಗಟ್ಟಿಮುಟ್ಟಾದ ದೇಹ
ವಾಸನೆಯಿಲ್ಲದಿರು	ಪರಿಚಯವಿಲ್ಲದಿರು
ವಿಶಾಲ ಮನಸ್ಸು	ಮಾನವೀಯ ಮನೋಭಾವ
ವಿಶಾಲ ಹೃದಯ	ಮಾನವೀಯತೆ
ವಿಷ ಕಾರು	ದ್ವೇಷ ಸಾಧಿಸು
ವಿಷ ಜಂತು	ಕೆಟ್ಟ ವ್ಯಕ್ತಿ
ವೀಳೆಯ ತೆಗೆದುಕೊಳ್ಳು	ಸಂಕಲ್ಪ ಮಾಡು
ಶಂಖ ಊದು	ಪ್ರಚಾರ ಮಾಡುತ್ತ ತಿರುಗು
ಶಂಖದಲ್ಲಿ ಬಂದಿದ್ದೇ ತೀರ್ಥ	ಅಧಿಕೃತವಾಗಿ ಹೊರಬೀಳುವುದಕ್ಕೇ ಬೆಲೆ
ಶತಾಯಗತಾಯ	ಯಾವುದಾದರೊಂದು ಬಗೆಯಲ್ಲಿ
ಶುಕ್ರದಶೆ	ಅದೃಷ್ಟದ ಕಾಲ
ಶ್ರುತಿ ಬದಲಿಸು	ಮಾತಿನ ವರಸೆ ಬದಲಿಸು
ಸಂಕುಚಿತ ಬುದ್ದಿ	ವಿಶಾಲ ಮನೋಭಾವವಿಲ್ಲದಿರುವಿಕೆ
ಸಂಜೀವನಿ	ಪರಮೌಷಧ
ಸಟ್ಟುಗ ಹಿಡಿ	ಅಡುಗೆ ಮಾಡು
ಸತ್ತುಹುಟ್ಟು	ಆತಂಕಪಡು
ಸಂನ್ಯಾಸಿಯ ಸಂಸಾರ	ಅವಶ್ಯಕತೆಯಿಲ್ಲದ ಸಂಬಂಧ
ವಿರೋಧಿ ಸರ್ಕಸ್ ಮಾಡು	ಬಗೆಬಗೆಯಾಗಿ ಪ್ರಯತ್ನಿಸು
ಸಾಕುಬೇಕಾಗು	ಕಷ್ಟವೆನಿಸು
ಸಿಂಹ ಪಾಲು	ದೊಡ್ಡ ಭಾಗ
ಸಿಟ್ಟಿನ ಕೈಗೆ ಬುದ್ದಿ ಕೊಡು	ವಿವೇಚನೆಯಿಲ್ಲದ ಅತಿಯಾದ ಕೋಪ
ಸುವರ್ಣಾಕ್ಷರದಲ್ಲಿ ಬರೆದಿಡು	ಹಿರಿಮೆಯನ್ನು ಶಾಶ್ವತವಾಗಿ ದಾಖಲಿಸು
ಸೇತುವೆಯಾಗು	ಸಂಪರ್ಕವ್ಯಕ್ತಿಯಾಗು
ಸೇರಿಗೆ ಸವ್ವಾಸೇರು	ಒಂದನ್ನೊಂದು ಮೀರಿಸಿರು
ಸೋಪಾನ	ಮಾರ್ಗದ ಹಂತ
ಸ್ವಂತ ಕಾಲ ಮೇಲೆ ನಿಲ್ಲು	ಸ್ವಾವಲಂಬಿಯಾಗು
ಹಂಗಿನ ಬದುಕು	ಋಣದ ಜೀವನ
ಹಗಲುಗನಸು	ಈಡೇರದ ಆಸೆ
ಹಗಲುದರೋಡೆ	ನಿರ್ಭಯವಾದ ಲೂಟಿ
ಹಗುರವಾಗು	ಸುಲಭವಾಗು
ಹತ್ತಿಕ್ಕು	ನಿಯಂತ್ರಿಸು
ಹರಿಹಂಚಾಗು	ಒಡೆದು ಚೂರಾಗು
ಹರುಷದ ಚಿಲುಮೆ	ಸದಾ ಸಂತೋಷದಿಂದಿರುವಿಕೆ
ಹಲ್ಲಿಗೆ ಹತ್ತದಿರು	ತಿನ್ನಲು ಸಾಕಾಗದಿರು
ಹಾಲು ಕುಡಿ	ಸಂತೋಷಪಡು
ಹಾಸಿ ಹೊದೆಯುವಷ್ಟಿರು	ಬೇಕಾದಷ್ಟಿರು
ಹಿಂದೆ ಮುಂದೆ ನೋಡು	ಮನಸ್ಸು ಮಾಡದಿರು
ಹಿಂದಿಲ್ಲ ಮುಂದಿಲ್ಲ	ಬಂಧುಬಾಂಧವರಿಲ್ಲದ
ಹಿಡಿತದಲ್ಲಿರಿಸು	ಹತೋಟಿಯಲ್ಲಿಡು
ಹುಚ್ಚು	ಗೀಳು
ಹುಟ್ಟಡಗು	ನಾಶವಾಗು
ಹುಟ್ಟಡಗಿಸು	ನಾಶಮಾಡು
ಹುರುಳಿಲ್ಲದಿರು	ಸತ್ವವಿಲ್ಲದಿರು
ಹುಲ್ಲಿಗಿಂತ ಕಡೆಯಾಗಿ ಎಣಿಸು	ಅಲಕ್ಷ್ಯ ಮಾಡು
ಹುಲ್ಲು ತುಂಬಿರು	ಬುದ್ದಿ ಇಲ್ಲದಿರು
ಹುಲ್ಲುಕಡ್ಡಿಯಷ್ಟು	ಸ್ವಲ್ಪವಾದರೂ
ಹೂವೆತ್ತಿದ ಹಾಗೆ	ಸುಲಭವಾಗು
ಹೃದಯ ತುಂಬಿ ಬರು	ಭಾವುಕನಾಗು
ಹೃದಯಸ್ಪರ್ಶಿ	ಮನಸ್ಸಿಗೆ ನಾಟು
ಹೆಗಲ ಮೇಲೆ ಹಾಕು	ಜವಾಬ್ದಾರಿ ವಹಿಸು
ಹೆಗಲಿಗೆ ಹೆಗಲು ಕೊಡು	ಸಹಕಾರ ನೀಡು
ಹೆಜ್ಜೆಯಲ್ಲಿ ನಡೆ	ಅನುಸರಿಸು
ಹೆತ್ತ ಕರುಳು	ತಾಯಿಯ ಮಮತೆ
ಹೆಸರೆತ್ತದಿರು	ದ್ವೇಷ ಸಾಧಿಸು
ಹೆಸರುವಾಸಿ	ಪ್ರಸಿದ್ಧ
ಹೆಸರಿಲ್ಲದಂತೆ ಮಾಡು	ನಾಶಮಾಡು
ಹೇಳಹೆಸರಿಲ್ಲದಾಗು	ನಾಶವಾಗು
ಹೇಳಿದಂತೆ ಕುಣಿ	ಆಜ್ಞಾಪಾಲಕನಾಗು
ಹೊಂಗನಸು	ಉತ್ತಮವಾದ ಕಲ್ಪನೆ
ಹೊಂಡಕ್ಕೆ ಬೀಳು	ಮೋಸಹೋಗು
ಹೊಟ್ಟೆಗಿಲ್ಲದಿರು	ಹಸಿದಿರು
ಹೊಟ್ಟೆಗೆ ಹಾಕಿಕೊ	ಕ್ಷಮಿಸು
ಹೊಟ್ಟೆ ಬೆನ್ನಿಗೆ ಅಂಟು	ಆಹಾರವಿಲ್ಲದೆ ಕೃಶವಾಗು
ಹೊಟ್ಟೆಯಲ್ಲೇ ಇಟ್ಟುಕೊಳ್ಳು	ರಹಸ್ಯವನ್ನು ಕಾಪಾಡು
ಹೊಟ್ಟೆಪಾಡು	ಬದುಕಿನ ದಾರಿ
ಹೊರಹಾಕು	ಬಹಿಷ್ಕರಿಸು
ತವರಿಗೆ ಬಂದ ಹೊರೆಸಿ ಕಳಿಸು	ಉಡುಗೊರೆ ಕೊಟ್ಟು ಕಳಿಸು
ಹೊಸ ಅಧ್ಯಾಯವನ್ನು ಪ್ರಾರಂಭಿಸು	ಹೊಸದಾಗಿ ತೊಡಗು
ಹೊಸ ರಾಗ	ಮತ್ತೊಂದು ವರಸೆ
ಹೊಸ್ತಿಲು ತುಳಿ	ಪ್ರವೇಶಿಸು
ಹೊಸ್ತಿಲು ದಾಟು	ಹೊರಗೆ ತಿರುಗಾಡು
ಹೋಗುವ ಕಾಲ	ವಿನಾಶಕಾಲ